"","Fire_ID","Fire_Year","Fire_Start","BurnDay","Snow_Acc","SnowAccDay","SnowMeltDay","Snow_Melt","SnowCoverDays","ymdPS","peakSnow","sweMean","sweMedian","doPS","tdps","tssm"
"1","KLK9_2004_1508",2004,2004-10-01,274,2003-10-22,294,105,2004-04-15,176,2004-03-28,206.7767384,81.39260588,80.33333588,87,18,169
"2","THU31_2005_1510",2005,2005-07-26,206,2004-10-19,292,107,2005-04-18,180,2005-03-29,153.776764,59.92700134,42.88999939,87,20,99
"3","HEA63_2005_1511",2005,2005-08-11,222,2004-10-21,294,107,2005-04-18,178,2005-03-27,188.9886487,76.7615575,58.22000122,85,22,115
"4","TIM19_2005_1512",2005,2005-07-15,195,2004-11-04,308,106,2005-04-17,163,2005-03-26,142.2106616,51.85581556,34.75,84,22,89
"5","CHA18_2005_1513",2005,2005-07-18,198,2004-09-29,272,108,2005-04-19,201,2005-03-27,180.3753234,71.09339736,67.16000366,85,23,90
"6","TIM7_2005_1515",2005,2005-05-27,146,2004-11-13,317,107,2005-04-18,155,2005-03-27,182.0958228,70.43967607,61.02999878,85,22,39
"7","TIM5_2005_1517",2005,2005-05-27,146,2004-09-21,264,100,2005-04-11,201,2005-03-27,174.0226714,65.73929989,60.63500214,85,15,46
"8","FOR14_2005_1514",2005,2005-08-07,218,2004-09-08,251,97,2005-04-08,211,2005-03-22,93.33455112,30.37253427,5.539999962,80,17,121
"9","FOR24_2005_1516",2005,2005-08-02,213,2004-10-09,282,101,2005-04-12,184,2005-03-27,99.26597273,33.08059568,13.0425005,85,16,112
"10","SLK40_2005_1534",2005,2005-08-07,218,2004-10-04,277,107,2005-04-18,195,2005-03-29,160.1446363,63.92028874,52.61999893,87,20,111
"11","SLK25_2005_1535",2005,2005-07-12,192,2004-10-04,277,107,2005-04-18,195,2005-03-29,140.3319024,54.67903675,37.54899979,87,20,85
"12","NIP104_2005_1536",2005,2005-08-09,220,2004-10-19,292,107,2005-04-18,180,2005-03-29,152.0404794,62.11634995,36.56999969,87,20,113
"13","WAW21_2003_1406",2003,2003-06-21,171,2002-11-02,305,113,2003-04-24,173,2003-04-09,182.1219269,80.69002273,72.40663064,98,15,58
"14","SLK20_2003_1434",2003,2003-05-17,136,2002-11-07,310,122,2003-05-03,177,2003-03-20,105.7795996,49.4120488,58.22000122,78,44,14
"15","SAU7_2003_1436",2003,2003-05-06,125,2002-12-04,337,95,2003-04-06,123,2003-03-15,77.68750471,20.15449325,3.186666727,73,22,30
"16","RED65_2003_1440",2003,2003-06-18,168,2002-10-18,290,138,2003-05-19,213,2003-04-07,59.44143199,19.75185831,16.90999985,96,42,30
"17","KLK5_2003_1495",2003,2003-05-20,139,2002-11-13,316,108,2003-04-19,157,2003-03-16,124.0590473,46.03131075,29.93000031,74,34,31
"18","KLK9_2003_1496",2003,2003-05-07,126,2002-10-03,275,126,2003-05-07,216,2003-04-09,188.2852965,80.89306512,72.16999817,98,28,0
"19","THU28_2003_1502",2003,2003-05-09,128,2002-11-23,326,107,2003-04-18,146,2003-04-08,135.814382,50.15644518,27.62000084,97,10,21
"20","WAW23_2003_1503",2003,2003-06-21,171,2002-10-08,280,121,2003-05-02,206,2003-04-08,150.5069679,66.72090199,66.23999786,97,24,50
"21","THU66_2003_1537",2003,2003-06-23,173,2002-11-07,310,127,2003-05-08,182,2003-04-08,97.79536204,46.33181585,52.40200043,97,30,46
"22","NIP112_2005_1518",2005,2005-08-08,219,2004-10-04,277,111,2005-04-22,199,2005-03-29,146.3170349,58.18673347,35.59999847,87,24,108
"23","COC10_2005_1519",2005,2005-05-27,146,2004-10-31,304,108,2005-04-19,169,2005-03-26,194.9808921,79.75885767,71.55999756,84,24,38
"24","NIP20_2005_1521",2005,2005-06-21,171,2004-10-19,292,108,2005-04-19,181,2005-03-29,167.9520025,68.27493013,42.01250076,87,21,63
"25","NIP52_2005_1522",2005,2005-07-26,206,2004-09-17,260,105,2005-04-16,210,2005-03-27,140.8121542,53.09505232,40.30999756,85,20,101
"26","THU30_2005_1525",2005,2005-07-25,205,2004-10-03,276,109,2005-04-20,198,2005-03-29,207.6580087,86.43904742,61.5,87,22,96
"27","THU57_2005_1526",2005,2005-08-07,218,2004-10-13,286,105,2005-04-16,184,2005-03-28,154.3019078,61.10283411,41.84883924,86,19,113
"28","THU67_2005_1528",2005,2005-08-08,219,2004-10-05,278,107,2005-04-18,194,2005-03-28,199.294619,82.23998493,57.68000031,86,21,112
"29","TIM56_2005_1529",2005,2005-07-18,198,2004-10-17,290,100,2005-04-11,175,2005-03-27,174.8102394,66.33925334,55.81500244,85,15,98
"30","FOR18_2005_1520",2005,2005-08-01,212,2004-10-03,276,105,2005-04-16,194,2005-03-27,97.06316424,33.16422735,15.52750015,85,20,107
"31","NIP80_2005_1523",2005,2005-08-18,229,2004-10-01,274,113,2005-04-24,204,2005-03-27,102.6686872,38.77635534,17.29000092,85,28,116
"32","THU65_2005_1527",2005,2005-08-10,221,2004-10-03,276,113,2005-04-24,202,2005-03-29,191.2516255,77.3400748,54.30833054,87,26,108
"33","SLK11_2007_1658",2007,2007-05-11,130,2006-10-04,276,114,2007-04-25,203,2007-03-20,107.580315,38.10078507,20.79634457,78,36,16
"34","DRY10_2007_1659",2007,2007-05-06,125,2006-10-05,277,112,2007-04-23,200,2007-03-20,94.16253733,32.45644047,17.42000008,78,34,13
"35","NIP26_2007_1660",2007,2007-05-11,130,2006-09-26,268,112,2007-04-23,209,2007-03-20,118.8747182,40.90257803,10.39000034,78,34,18
"36","THU39_2007_1661",2007,2007-05-14,133,2006-10-15,287,112,2007-04-23,190,2007-03-20,127.7505519,45.7510355,21.84687519,78,34,21
"37","THU37_2007_1662",2007,2007-05-10,129,2006-10-14,286,114,2007-04-25,193,2007-03-21,75.5863553,22.67134401,15.61642838,79,35,15
"38","SAU78_2006_1560",2006,2006-09-18,260,2005-10-18,290,109,2006-04-20,184,2006-03-07,108.5956824,34.35934693,8.550000191,65,44,151
"39","SUD8_2006_1561",2006,2006-05-10,129,2005-10-16,288,82,2006-03-24,159,2006-03-08,96.9593959,21.73433205,3.575999975,66,16,47
"40","NIP262_2006_1567",2006,2006-09-08,250,2005-11-09,312,110,2006-04-21,163,2006-12-31,138.1188533,62.13222301,65.56832886,364,-254,140
"41","THU113_2006_1568",2006,2006-09-08,250,2005-11-08,311,85,2006-03-27,139,2006-03-06,58.78702758,20.52385089,8.920000076,64,21,165
"42","NIP406_2006_1569",2006,2006-09-14,256,2005-11-18,321,107,2006-04-18,151,2006-12-31,119.6219287,48.50019035,47.93999863,364,-257,149
"43","NIP322_2006_1573",2006,2006-09-09,251,2005-10-09,281,83,2006-03-25,167,2006-04-10,81.8198507,31.70741015,32.29000092,99,-16,168
"44","NIP391_2006_1575",2006,2006-09-15,257,2005-10-22,294,85,2006-03-27,156,2006-12-31,122.1529699,49.16758104,47.13199997,364,-279,172
"45","NIP70_2006_1583",2006,2006-07-14,194,2005-09-30,272,113,2006-04-24,206,2006-12-31,107.3205847,30.8676066,27.17000008,364,-251,81
"46","NIP257_2006_1604",2006,2006-09-08,250,2005-11-27,330,89,2006-03-31,124,2006-10-29,59.84722614,20.19237435,5.869999886,301,-212,161
"47","NIP245_2006_1605",2006,2006-09-08,250,2005-11-12,315,110,2006-04-21,160,2006-12-31,106.5845367,42.38761126,41.57999802,364,-254,140
"48","COC14_2006_1606",2006,2006-05-10,129,2005-09-15,257,112,2006-04-23,220,2006-03-22,202.5241581,78.13183129,66.77999878,80,32,17
"49","NIP323_2006_1607",2006,2006-09-16,258,2005-11-02,305,85,2006-03-27,145,2006-05-18,47.81121224,16.70013587,6.889999866,137,-52,173
"50","NIP328_2006_1608",2006,2006-09-09,251,2005-09-30,272,85,2006-03-27,178,2006-10-15,45.32481927,15.41280853,5.659999847,287,-202,166
"51","NIP296_2006_1609",2006,2006-09-15,257,2005-10-07,279,85,2006-03-27,171,2006-12-23,53.914381,19.33951882,7.650000095,356,-271,172
"52","THU189_2006_1610",2006,2006-09-15,257,2005-11-13,316,85,2006-03-27,134,2006-03-07,81.99724774,30.72518066,27.39999962,65,20,172
"53","THU185_2006_1633",2006,2006-09-15,257,2005-11-12,315,85,2006-03-27,135,2006-12-31,81.06146373,21.00339447,5.340000153,364,-279,172
"54","THU144_2006_1638",2006,2006-09-17,259,2005-09-30,272,105,2006-04-16,198,2006-12-31,86.97557086,25.56656742,13.66499996,364,-259,154
"55","THU249_2006_1639",2006,2006-09-10,252,2005-11-02,305,85,2006-03-27,145,2006-12-31,62.09759546,15.16748393,1.910000086,364,-279,167
"56","THU163_2006_1640",2006,2006-09-15,257,2005-11-12,315,85,2006-03-27,135,2006-12-31,56.12337737,13.90444057,2.079999924,364,-279,172
"57","THU143_2006_1642",2006,2006-09-12,254,2005-09-30,272,105,2006-04-16,198,2006-12-31,80.85655075,24.98050738,14.36999989,364,-259,149
"58","NIP344_2006_1643",2006,2006-09-16,258,2005-11-12,315,109,2006-04-20,159,2006-12-31,131.0957937,53.89603408,54.51499939,364,-255,149
"59","NIP226_2006_1644",2006,2006-09-08,250,2005-09-30,272,118,2006-04-29,211,2006-12-31,50.81754937,14.17603216,3.960000038,364,-246,132
"60","NIP414_2006_1648",2006,2006-09-14,256,2005-11-12,315,109,2006-04-20,159,2006-12-31,131.6008629,55.0828196,57.2460022,364,-255,147
"61","COC8_2006_1649",2006,2006-05-10,129,2005-11-18,321,109,2006-04-20,153,2006-03-22,217.543905,85.7985457,73.73000336,80,29,20
"62","THU151_2006_1650",2006,2006-09-08,250,2005-09-15,257,83,2006-03-25,191,2006-12-31,68.01757158,20.77605425,6.980000019,364,-281,167
"63","NIP108_2006_1651",2006,2006-07-19,199,2005-11-09,312,110,2006-04-21,163,2006-12-31,129.5457335,52.21030111,52.49124908,364,-254,89
"64","THU176_2006_1652",2006,2006-09-08,250,2005-11-12,315,83,2006-03-25,133,2006-12-31,70.27127464,28.46076859,26.14999962,364,-281,167
"65","THU167_2006_1653",2006,2006-09-09,251,2005-09-29,271,106,2006-04-17,200,2006-12-31,78.00314571,24.49128572,14.19999981,364,-258,145
"66","COC9_2006_1654",2006,2006-05-10,129,2005-11-16,319,109,2006-04-20,155,2006-03-22,210.8134082,82.14080759,68.25,80,29,20
"67","NIP411_2006_1657",2006,2006-09-13,255,2005-10-24,296,108,2006-04-19,177,2006-12-31,121.2735909,44.18630322,41.43999863,364,-256,147
"68","NIP338_2006_1664",2006,2006-09-12,254,2005-11-17,320,85,2006-03-27,130,2006-12-01,51.53673364,16.68679466,4.190000057,334,-249,169
"69","SLK48_2006_1681",2006,2006-08-31,242,2005-09-20,262,122,2006-05-03,225,2006-03-27,95.96955528,41.0272943,43.22000122,85,37,120
"70","RED44_2006_1683",2006,2006-07-13,193,2005-10-01,273,108,2006-04-19,200,2006-03-06,104.5014798,40.13122595,31.48999977,64,44,85
"71","NIP81_2006_1684",2006,2006-07-16,196,2005-09-23,265,109,2006-04-20,209,2006-12-31,94.62521576,33.72909233,33.18999863,364,-255,87
"72","COC34_2006_1686",2006,2006-08-04,215,2005-11-09,312,109,2006-04-20,162,2006-03-21,154.1400947,56.50561302,47.18999863,79,30,106
"73","THU133_2006_1688",2006,2006-09-11,253,2005-10-02,274,122,2006-05-03,213,2006-12-31,66.41711873,23.94521486,16.95166588,364,-242,131
"74","THU192_2006_1689",2006,2006-09-15,257,2005-10-30,302,106,2006-04-17,169,2006-12-31,77.10250557,27.6476543,21.39999962,364,-258,151
"75","DRY79_2006_1692",2006,2006-07-21,201,2005-09-22,264,108,2006-04-19,209,2006-03-05,86.1419258,28.10911091,7.675000191,63,45,93
"76","SLK30_2006_1581",2006,2006-06-28,178,2005-09-29,271,115,2006-04-26,209,2006-03-27,88.560932,37.65348334,33.59999847,85,30,63
"77","NIP365_2006_1574",2006,2006-09-15,257,2005-10-09,281,106,2006-04-17,190,2006-12-31,98.40424036,37.26188489,28.71999931,364,-258,151
"78","SLK45_2006_1599",2006,2006-07-09,189,2005-09-20,262,128,2006-05-09,231,2006-03-27,92.36859915,38.27660913,40.13333511,85,43,61
"79","RED184_2006_1678",2006,2006-09-06,248,2005-10-15,287,115,2006-04-26,193,2006-03-27,88.38192771,34.27146112,21.82500076,85,30,133
"80","RED193_2006_1682",2006,2006-09-04,246,2005-09-29,271,113,2006-04-24,207,2006-03-27,82.08181891,32.53039014,20.36639851,85,28,133
"81","NIP409_2006_1570",2006,2006-09-14,256,2005-11-04,307,87,2006-03-29,145,2006-12-29,119.872362,48.40233711,48.2179985,362,-275,169
"82","NIP238_2006_1571",2006,2006-09-15,257,2005-09-27,269,85,2006-03-27,181,2006-12-31,121.6001611,48.32642367,45.69200134,364,-279,172
"83","NIP426_2006_1572",2006,2006-09-08,250,2005-11-09,312,113,2006-04-24,166,2006-12-31,122.9214873,51.84972161,51.13999939,364,-251,137
"84","RED84_2006_1576",2006,2006-08-25,236,2005-10-15,287,111,2006-04-22,189,2006-03-26,82.49944871,31.93415056,21.28080188,84,27,125
"85","RED175_2006_1577",2006,2006-09-06,248,2005-10-25,297,113,2006-04-24,181,2006-03-26,77.95327311,29.85322207,20.81999969,84,29,135
"86","RED177_2006_1579",2006,2006-09-03,245,2005-09-03,245,114,2006-04-25,234,2006-03-26,101.0154962,39.80748618,25.25,84,30,131
"87","NIP189_2006_1580",2006,2006-09-02,244,2005-10-21,293,113,2006-04-24,185,2006-12-31,78.14270521,25.00157117,23.27500153,364,-251,131
"88","NIP440_2006_1601",2006,2006-09-15,257,2005-11-09,312,110,2006-04-21,163,2006-12-31,127.351216,51.6090014,58.65800095,364,-254,147
"89","NIP410_2006_1602",2006,2006-09-15,257,2005-11-12,315,107,2006-04-18,157,2006-12-31,127.7683886,52.31134196,59.20800018,364,-257,150
"90","NIP291_2006_1611",2006,2006-09-08,250,2005-10-24,296,80,2006-03-22,149,2006-12-31,110.7794726,42.50411271,37.75999832,364,-284,170
"91","NIP404_2006_1612",2006,2006-09-14,256,2005-09-06,248,106,2006-04-17,223,2006-12-31,110.9117119,43.26271743,31.65999985,364,-258,150
"92","NIP400_2006_1613",2006,2006-09-08,250,2005-09-23,265,106,2006-04-17,206,2006-12-31,112.6840909,43.73493786,38.61000061,364,-258,144
"93","NIP341_2006_1614",2006,2006-09-15,257,2005-11-11,314,85,2006-03-27,136,2006-03-09,91.24501339,35.99748978,37.2816658,67,18,172
"94","NIP402_2006_1615",2006,2006-09-09,251,2005-11-09,312,106,2006-04-17,159,2006-12-31,111.4285361,42.79949765,37.20999908,364,-258,145
"95","NIP334_2006_1616",2006,2006-09-14,256,2005-11-09,312,109,2006-04-20,162,2006-10-02,114.9259393,45.95882623,40.60499954,274,-165,147
"96","FOR52_2006_1617",2006,2006-07-07,187,2005-10-07,279,106,2006-04-17,192,2006-03-06,35.78109731,9.14386725,0,64,42,81
"97","FOR173_2006_1618",2006,2006-09-12,254,2005-10-07,279,85,2006-03-27,171,2006-03-06,46.76581376,12.77187152,0,64,21,169
"98","FOR54_2006_1619",2006,2006-07-18,198,2005-10-29,301,85,2006-03-27,149,2006-03-06,41.16171416,10.60551234,0,64,21,113
"99","FOR165_2006_1620",2006,2006-09-10,252,2005-09-29,271,83,2006-03-25,177,2006-03-06,39.0123101,9.862893766,0,64,19,169
"100","FOR57_2006_1621",2006,2006-07-18,198,2005-11-12,315,85,2006-03-27,135,2006-03-06,42.97407536,11.11561676,0,64,21,113
"101","FOR63_2006_1622",2006,2006-07-13,193,2005-10-07,279,85,2006-03-27,171,2006-03-06,44.18283467,11.43164428,0,64,21,108
"102","FOR179_2006_1623",2006,2006-09-12,254,2005-10-08,280,85,2006-03-27,170,2006-03-06,46.24969121,12.02811417,0,64,21,169
"103","FOR61_2006_1624",2006,2006-07-18,198,2005-10-07,279,85,2006-03-27,171,2006-03-06,49.23272982,12.8353494,0.469999999,64,21,113
"104","RED163_2006_1625",2006,2006-09-12,254,2005-09-20,262,115,2006-04-26,218,2006-03-27,100.5133236,41.20650162,30.07999992,85,30,139
"105","RED182_2006_1626",2006,2006-09-04,246,2005-09-25,267,114,2006-04-25,212,2006-03-26,79.82332818,30.980645,17.34914201,84,30,132
"106","RED183_2006_1627",2006,2006-09-01,243,2005-09-18,260,110,2006-04-21,215,2006-03-26,57.47425251,23.09000066,12.48999977,84,26,133
"107","RED146_2006_1628",2006,2006-08-26,237,2005-10-07,279,113,2006-04-24,199,2006-03-27,97.91434878,38.53912514,23.30999947,85,28,124
"108","RED113_2006_1629",2006,2006-08-26,237,2005-10-08,280,115,2006-04-26,200,2006-03-27,100.3897727,40.07911703,24.3037789,85,30,122
"109","RED176_2006_1632",2006,2006-09-07,249,2005-10-11,283,115,2006-04-26,197,2006-03-26,87.78850045,33.80416838,20.63999939,84,31,134
"110","THU142_2006_1634",2006,2006-09-13,255,2005-11-12,315,101,2006-04-12,151,2006-12-31,85.09124353,25.18674713,13.17505121,364,-263,154
"111","THU234_2006_1635",2006,2006-09-13,255,2005-10-07,279,85,2006-03-27,171,2006-12-31,52.04848349,13.49162954,2.364000082,364,-279,170
"112","THU190_2006_1636",2006,2006-09-16,258,2005-10-07,279,85,2006-03-27,171,2006-12-31,50.50124721,13.09066894,2.394000053,364,-279,173
"113","NIP430_2006_1637",2006,2006-09-12,254,2005-09-30,272,118,2006-04-29,211,2006-12-31,47.95923164,13.18589221,2.769999981,364,-246,136
"114","NIP267_2006_1641",2006,2006-09-08,250,2005-10-19,291,110,2006-04-21,184,2006-12-31,112.5060681,38.97731271,34.49000168,364,-254,140
"115","NIP415_2006_1645",2006,2006-09-08,250,2005-09-27,269,107,2006-04-18,203,2006-12-31,131.3486448,54.10592798,54.99000168,364,-257,143
"116","NIP428_2006_1646",2006,2006-09-16,258,2005-11-18,321,86,2006-03-28,130,2006-12-31,44.52679982,13.19127579,2.670000076,364,-278,172
"117","THU184_2006_1647",2006,2006-09-15,257,2005-11-08,311,105,2006-04-16,159,2006-12-31,80.14511971,24.57624444,14.72000027,364,-259,152
"118","NIP276_2006_1655",2006,2006-09-16,258,2005-11-12,315,106,2006-04-17,156,2006-12-31,123.6793415,47.63216108,46.76666641,364,-258,152
"119","NIP413_2006_1656",2006,2006-09-14,256,2005-10-31,303,110,2006-04-21,172,2006-12-31,124.6592229,49.83478202,57.35400009,364,-254,146
"120","NIP380_2006_1663",2006,2006-09-10,252,2005-09-11,253,110,2006-04-21,222,2006-12-31,108.8072508,41.70305269,38.70000076,364,-254,142
"121","SLK40_2006_1672",2006,2006-07-16,196,2005-09-06,248,116,2006-04-27,233,2006-04-08,113.7732587,46.25363305,40.09000015,97,19,80
"122","RED69_2006_1673",2006,2006-07-19,199,2005-11-11,314,116,2006-04-27,167,2006-03-27,105.681588,42.72348881,34.43333435,85,31,83
"123","SLK38_2006_1674",2006,2006-08-03,214,2005-09-29,271,122,2006-05-03,216,2006-03-27,92.20849427,37.98057822,32.00999832,85,37,92
"124","SLK42_2006_1675",2006,2006-07-15,195,2005-10-05,277,118,2006-04-29,206,2006-03-27,79.93647266,31.58333415,29.44000053,85,33,77
"125","RED188_2006_1676",2006,2006-09-01,243,2005-10-22,294,108,2006-04-19,179,2006-03-27,97.58952725,37.74089859,23.06999969,85,23,135
"126","RED186_2006_1677",2006,2006-07-06,186,2005-09-29,271,109,2006-04-20,203,2006-03-26,93.18497693,35.62136035,20.95999908,84,25,77
"127","RED16_2006_1679",2006,2006-07-07,187,2005-10-29,301,115,2006-04-26,179,2006-03-27,86.37455692,33.05455698,18.65999985,85,30,72
"128","RED192_2006_1680",2006,2006-09-05,247,2005-11-11,314,113,2006-04-24,164,2006-03-26,65.39031097,26.01920585,13.89000034,84,29,134
"129","THU154_2006_1687",2006,2006-09-11,253,2005-10-18,290,118,2006-04-29,193,2006-12-31,83.88498897,29.13451202,24.55500031,364,-246,135
"130","THU232_2006_1690",2006,2006-09-09,251,2005-10-30,302,106,2006-04-17,169,2006-12-31,75.54540276,27.19093217,19.72999954,364,-258,145
"131","RED68_2003_1428",2003,2003-06-23,173,2002-10-17,289,122,2003-05-03,198,2003-04-06,79.39899221,27.05534703,20.27000046,95,27,51
"132","WAW13_2003_1409",2003,2003-06-15,165,2002-10-13,285,113,2003-04-24,193,2003-04-08,154.9211723,69.70432109,71.37798099,97,16,52
"133","DRY57_2003_1410",2003,2003-06-21,171,2002-11-07,310,113,2003-04-24,168,2003-04-06,79.4416667,32.56598672,26.69000053,95,18,58
"134","SLK58_2003_1412",2003,2003-06-21,171,2002-10-17,289,128,2003-05-09,204,2003-04-07,98.32335298,38.6997872,33.544503,96,32,43
"135","NIP58_2003_1421",2003,2003-06-22,172,2002-10-22,294,120,2003-05-01,191,2003-04-04,98.64282163,43.09779398,42.63999939,93,27,52
"136","KEN110_2003_1423",2003,2003-08-19,230,2002-11-07,310,97,2003-04-08,152,2003-03-13,63.45498728,16.20428789,8.690000534,71,26,133
"137","DRY58_2003_1441",2003,2003-06-19,169,2002-10-07,279,104,2003-04-15,190,2003-03-13,48.80277337,13.05666437,4.08166647,71,33,65
"138","SLK57_2003_1479",2003,2003-06-21,171,2002-10-18,290,128,2003-05-09,203,2003-04-07,104.1720186,45.4893748,49.06270251,96,32,43
"139","NIP17_2003_1485",2003,2003-05-26,145,2002-10-14,286,120,2003-05-01,199,2003-04-08,102.8497785,45.08987183,49.58200073,97,23,25
"140","NIP40_2007_1564",2007,2007-06-13,163,2006-10-31,303,114,2007-04-25,176,2007-04-16,109.7047862,36.57484989,11.89999962,105,9,49
"141","KEN41_2007_1566",2007,2007-08-03,214,2006-09-26,268,124,2007-05-05,221,2007-03-22,96.50427053,29.61151465,21.57999992,80,44,90
"142","THU36_2007_1584",2007,2007-05-09,128,2006-10-15,287,112,2007-04-23,190,2007-03-20,97.23999786,31.48518181,6.300000191,78,34,16
"143","SUD46_2007_1586",2007,2007-05-20,139,2006-09-27,269,112,2007-04-23,208,2007-04-09,151.0725313,51.77417822,19.71500015,98,14,27
"144","SAU13_2007_1587",2007,2007-05-15,134,2006-10-16,288,108,2007-04-19,185,2007-04-11,223.9540885,81.3041944,39.56999969,100,8,26
"145","RED11_2007_1562",2007,2007-06-12,162,2006-09-27,269,134,2007-05-15,230,2007-04-14,119.4494761,40.8946545,42.13750076,103,31,28
"146","DRY8_2007_1565",2007,2007-04-30,119,2006-10-15,287,127,2007-05-08,205,2007-03-22,104.9619095,31.8388761,22.22999954,80,47,-8
"147","TIM3_2007_1585",2007,2007-05-24,143,2006-09-23,265,112,2007-04-23,212,2007-04-11,220.0372704,80.50167711,53.61999893,100,12,31
"148","PEM2_2007_1588",2007,2007-05-09,128,2006-11-07,310,107,2007-04-18,162,2007-03-21,155.152957,50.44146109,5.313333511,79,28,21
"149","THU19_2016_2001",2016,2016-05-23,143,2015-11-15,318,96,2016-04-06,143,2016-04-13,145.7700288,51.78047394,26.87000084,103,-7,47
"150","NOR32_2016_2002",2016,2016-08-02,214,2015-10-28,300,104,2016-04-14,169,2016-04-10,141.843246,50.93654127,9.215000153,100,4,110
"151","NIP12_2016_2003",2016,2016-05-24,144,2015-11-15,318,101,2016-04-11,148,2016-04-13,122.6188173,47.62146006,39.18000031,103,-2,43
"152","HEA4_2016_2004",2016,2016-05-24,144,2015-10-19,291,98,2016-04-08,172,2016-04-13,158.8084043,58.97419506,44.99595261,103,-5,46
"153","RED3_2016_2005",2016,2016-05-07,127,2015-10-16,288,92,2016-04-02,169,2016-02-29,67.10860403,21.79432029,3.843404875,59,33,35
"154","SUD35_2016_2006",2016,2016-06-21,172,2015-11-23,326,98,2016-04-08,137,2016-04-10,181.2255369,62.79452828,20.07500076,100,-2,74
"155","WAW7_2016_2010",2016,2016-05-24,144,2015-10-06,278,98,2016-04-08,185,2016-04-10,181.5252024,70.49719123,53.44499969,100,-2,46
"156","HEA5_2016_2011",2016,2016-05-26,146,2015-10-24,296,98,2016-04-08,167,2016-04-13,160.1117717,59.31400634,45.41875076,103,-5,48
"157","SLK6_2016_2012",2016,2016-05-23,143,2015-09-23,265,139,2016-05-19,239,2016-04-13,68.62387189,25.24035488,18.27000046,103,36,4
"158","KEN18_2016_2014",2016,2016-05-09,129,2015-10-16,288,93,2016-04-03,170,2016-03-05,92.80725213,29.93294583,4.639999866,64,29,36
"159","APK20_2016_2015",2016,2016-08-10,222,2015-11-14,317,103,2016-04-13,151,2016-04-10,226.8356881,77.04976439,51.54416656,100,3,119
"160","NIP15_2016_2013",2016,2016-05-24,144,2015-10-20,292,111,2016-04-21,184,2016-04-13,106.5197246,42.88267,27.65999985,103,8,33
"161","SLK23_2016_2000",2016,2016-07-21,202,2015-09-29,271,134,2016-05-14,228,2016-04-13,72.61781379,26.40909133,25.32500076,103,31,68
"162","SLK29_2016_2007",2016,2016-07-18,199,2015-09-29,271,121,2016-05-01,215,2016-04-12,70.56358705,27.10867776,23.02000046,102,19,78
"163","SLK30_2016_2016",2016,2016-07-18,199,2015-09-30,272,113,2016-04-23,206,2016-04-13,77.78652412,29.57645308,23.49499893,103,10,86
"164","NIP23_2016_2022",2016,2016-07-11,192,2015-09-29,271,113,2016-04-23,207,2016-04-13,87.45068544,33.52298026,19.88999939,103,10,79
"165","FOR2_2019_2166",2019,2019-05-12,131,2018-10-18,290,98,2019-04-09,173,2019-03-12,117.1918454,37.37392349,19.57999992,70,28,33
"166","RED38_2019_2171",2019,2019-07-02,182,2018-10-05,277,120,2019-05-01,208,2019-04-14,83.10594119,27.31035556,9.899999619,103,17,62
"167","RED39_2019_2172",2019,2019-07-02,182,2018-10-04,276,118,2019-04-29,207,2019-04-11,86.14372755,28.92677522,12.66062952,100,18,64
"168","TIM2_2019_2173",2019,2019-06-08,158,2018-10-29,301,117,2019-04-28,181,2019-04-09,228.6432527,95.41770872,87.19048994,98,19,41
"169","RED14_2019_2176",2019,2019-05-31,150,2018-10-01,273,118,2019-04-29,210,2019-04-13,81.03159365,26.60757855,9.5625,102,16,32
"170","RED40_2019_2177",2019,2019-07-02,182,2018-10-04,276,119,2019-04-30,208,2019-04-14,90.64764024,29.20505127,9.227508042,103,16,63
"171","RED17_2019_2178",2019,2019-06-08,158,2018-10-05,277,119,2019-04-30,207,2019-04-14,100.5138683,33.40064582,15.5,103,16,39
"172","RED30_2019_2182",2019,2019-06-21,171,2018-09-26,268,127,2019-05-08,224,2019-04-14,60.81437861,19.01698105,4.980000019,103,24,44
"173","RED37_2019_2185",2019,2019-07-01,181,2018-10-01,273,121,2019-05-02,213,2019-04-12,87.1019453,28.92233717,10.36999989,101,20,60
"174","SLK22_2019_2187",2019,2019-07-04,184,2018-09-14,256,121,2019-05-02,230,2019-04-15,127.1894432,45.41557647,32.36000061,104,17,63
"175","SLK8_2019_2188",2019,2019-06-08,158,2018-10-01,273,121,2019-05-02,213,2019-04-15,140.5711846,47.89096203,33.05999756,104,17,37
"176","RED75_2019_2192",2019,2019-08-24,235,2018-09-12,254,108,2019-04-19,219,2019-03-19,86.26633042,27.45039999,9.095999718,77,31,127
"177","COC10_2019_2162",2019,2019-07-04,184,2018-09-18,260,139,2019-05-20,244,2019-04-12,191.6342657,83.24639293,73.41999817,101,38,45
"178","SLK40_2019_2163",2019,2019-08-02,213,2018-10-01,273,121,2019-05-02,213,2019-04-15,57.45102165,18.6222873,6.699999809,104,17,92
"179","RED23_2019_2164",2019,2019-06-17,167,2018-10-05,277,125,2019-05-06,213,2019-04-14,61.37384997,18.75811092,5.710000038,103,22,42
"180","RED44_2019_2165",2019,2019-07-02,182,2018-09-29,271,118,2019-04-29,212,2019-04-08,82.86987423,28.89919557,12.57973274,97,21,64
"181","SLK38_2019_2167",2019,2019-07-29,209,2018-10-14,286,137,2019-05-18,216,2019-04-15,83.23811873,29.22092735,20.72999954,104,33,72
"182","SLK33_2019_2168",2019,2019-07-29,209,2018-10-01,273,137,2019-05-18,229,2019-04-15,60.36773835,20.66367376,8.329999924,104,33,72
"183","RED45_2019_2169",2019,2019-07-05,185,2018-10-01,273,118,2019-04-29,210,2019-04-11,83.07383717,27.71717255,12.72641394,100,18,67
"184","SLK39_2019_2170",2019,2019-07-28,208,2018-10-01,273,137,2019-05-18,229,2019-04-15,89.39615993,30.88420783,17.37999916,104,33,71
"185","RED57_2019_2174",2019,2019-08-01,212,2018-09-26,268,121,2019-05-02,218,2019-04-14,60.26796424,20.11619583,6.349999905,103,18,91
"186","SLK37_2019_2175",2019,2019-07-29,209,2018-09-23,265,136,2019-05-17,236,2019-04-15,70.58240941,23.67479152,9.279999733,104,32,73
"187","NIP11_2019_2179",2019,2019-07-19,199,2018-10-13,285,102,2019-04-13,182,2019-03-09,99.9578726,29.33848916,4.716666698,67,35,97
"188","RED59_2019_2180",2019,2019-08-01,212,2018-10-07,279,115,2019-04-26,201,2019-04-11,60.05497373,18.15818454,6.449999809,100,15,97
"189","RED25_2019_2181",2019,2019-06-22,172,2018-10-15,287,121,2019-05-02,199,2019-04-14,60.19712298,19.32133207,6.289999962,103,18,51
"190","SLK41_2019_2183",2019,2019-07-29,209,2018-10-01,273,138,2019-05-19,230,2019-04-15,84.12609922,30.00393142,21.35000038,104,34,71
"191","SLK31_2019_2184",2019,2019-07-15,195,2018-10-01,273,136,2019-05-17,228,2019-04-15,57.51429105,18.53020637,6.260000229,104,32,59
"192","RED24_2019_2186",2019,2019-06-18,168,2018-10-04,276,121,2019-05-02,210,2019-04-14,67.11503719,21.24135826,5.550010031,103,18,47
"193","RED49_2019_2189",2019,2019-07-09,189,2018-10-18,290,118,2019-04-29,193,2019-04-06,80.06166063,28.36069856,15.92285633,95,23,71
"194","RED60_2019_2190",2019,2019-07-29,209,2018-09-23,265,137,2019-05-18,237,2019-04-14,60.13186289,19.92306312,6.079999924,103,34,72
"195","RED62_2019_2193",2019,2019-08-03,214,2018-10-01,273,137,2019-05-18,229,2019-04-14,62.40516988,20.49850867,6.079999924,103,34,77
"196","NIP95_2017_2114",2017,2017-08-12,223,2016-09-19,262,129,2017-05-10,232,2017-04-30,147.6261717,56.91470719,66.02999878,119,10,94
"197","RED31_2013_1862",2013,2013-07-04,184,2012-09-23,266,129,2013-05-10,228,2013-04-23,93.58868126,42.5936901,52.09955357,112,17,55
"198","NIP40_2013_1870",2013,2013-07-02,182,2012-09-15,258,155,2013-06-05,262,2013-04-25,93.60270119,40.26864226,47.02000046,114,41,27
"199","THU16_2013_1877",2013,2013-06-08,158,2012-10-27,300,130,2013-05-11,195,2013-04-21,174.1885498,70.99598258,67.75,110,20,28
"200","SLK25_2013_1861",2013,2013-06-10,160,2012-10-07,280,127,2013-05-08,212,2013-04-25,82.67556331,39.13756419,53.91500092,114,13,33
"201","SLK18_2013_1878",2013,2013-06-09,159,2012-09-11,254,155,2013-06-05,266,2013-12-31,78.14888056,36.35107971,49.41999817,364,-209,4
"202","NIP11_2013_1886",2013,2013-05-29,148,2012-10-12,285,135,2013-05-16,215,2013-04-25,86.83373994,35.95759159,40.91500092,114,21,13
"203","RED24_2013_1892",2013,2013-07-03,183,2012-09-18,261,131,2013-05-12,235,2013-04-25,80.54710841,36.91570432,47.29499817,114,17,52
"204","SLK24_2013_1895",2013,2013-06-10,160,2012-10-07,280,138,2013-05-19,223,2013-12-31,81.17296154,36.33852548,48.77764511,364,-226,22
"205","NIP48_2013_1860",2013,2013-07-12,192,2012-09-26,269,137,2013-05-18,233,2013-04-25,89.17896691,37.94563956,46.63999939,114,23,55
"206","SLK45_2013_1863",2013,2013-07-13,193,2012-09-18,261,138,2013-05-19,242,2013-12-08,83.39816272,39.52544724,53.31000137,341,-203,55
"207","NIP44_2013_1864",2013,2013-07-06,186,2012-10-07,280,127,2013-05-08,212,2013-04-21,155.2473735,62.57556117,65.43000031,110,17,59
"208","RED32_2013_1865",2013,2013-07-04,184,2012-09-23,266,131,2013-05-12,230,2013-04-25,91.64555281,42.00713158,51.48749924,114,17,53
"209","NIP50_2013_1866",2013,2013-07-08,188,2012-09-21,264,135,2013-05-16,236,2013-04-25,87.03032201,41.15193574,54.70000076,114,21,53
"210","NIP45_2013_1867",2013,2013-06-20,170,2012-10-11,284,127,2013-05-08,208,2013-04-21,109.2546469,44.30468527,49.63500214,110,17,43
"211","NIP43_2013_1868",2013,2013-07-04,184,2012-09-20,263,127,2013-05-08,229,2013-04-21,117.4419018,48.11223287,50.72000122,110,17,57
"212","SLK27_2013_1869",2013,2013-06-09,159,2012-09-08,251,151,2013-06-01,265,2013-05-04,102.2213304,44.32441048,56.86357117,123,28,8
"213","SLK19_2013_1871",2013,2013-06-08,158,2012-10-07,280,131,2013-05-12,216,2013-04-25,136.9496029,57.32909509,52.30500031,114,17,27
"214","NIP53_2013_1872",2013,2013-07-02,182,2012-09-06,249,135,2013-05-16,251,2013-04-25,92.61432493,38.30212697,42.2844429,114,21,47
"215","SLK16_2013_1873",2013,2013-06-10,160,2012-09-19,262,131,2013-05-12,234,2013-04-25,105.0807845,47.10586522,55.90166855,114,17,29
"216","NIP51_2013_1874",2013,2013-07-07,187,2012-10-08,281,135,2013-05-16,219,2013-12-31,76.70803331,30.41566546,39.08000183,364,-229,52
"217","SLK35_2013_1875",2013,2013-07-04,184,2012-09-21,264,131,2013-05-12,232,2013-04-25,129.2980712,55.28727413,63.46500015,114,17,53
"218","NIP19_2013_1876",2013,2013-07-05,185,2012-09-21,264,135,2013-05-16,236,2013-04-25,111.6951226,49.04461559,55.36000061,114,21,50
"219","NIP21_2013_1879",2013,2013-06-02,152,2012-09-22,265,131,2013-05-12,231,2013-04-25,108.8928018,47.88800936,53.91999817,114,17,21
"220","RED56_2013_1884",2013,2013-07-18,198,2012-09-23,266,127,2013-05-08,226,2013-05-03,144.7251486,58.88980067,64.22999573,122,5,71
"221","SLK23_2013_1885",2013,2013-06-11,161,2012-10-07,280,138,2013-05-19,223,2013-07-21,83.31572468,36.72519838,46.88176727,201,-63,23
"222","NIP25_2013_1887",2013,2013-06-10,160,2012-09-26,269,131,2013-05-12,227,2013-04-25,141.0212343,58.94844835,54.45833206,114,17,29
"223","RED41_2013_1888",2013,2013-07-07,187,2012-09-21,264,126,2013-05-07,227,2013-05-03,145.9027042,61.06589821,72.69499969,122,4,61
"224","SLK22_2013_1889",2013,2013-06-09,159,2012-09-22,265,131,2013-05-12,231,2013-04-25,88.21214914,41.23805823,55.34000015,114,17,28
"225","SLK21_2013_1890",2013,2013-06-08,158,2012-10-08,281,127,2013-05-08,211,2013-05-04,116.3466418,50.5420943,63.57499695,123,4,31
"226","SLK31_2013_1891",2013,2013-06-24,174,2012-10-02,275,131,2013-05-12,221,2013-05-04,93.60795644,40.82970404,52.05211309,123,8,43
"227","SLK37_2013_1893",2013,2013-07-05,185,2012-09-07,250,131,2013-05-12,246,2013-04-25,104.2302909,46.3761134,58.5633316,114,17,54
"228","NIP23_2013_1894",2013,2013-06-08,158,2012-10-12,285,137,2013-05-18,217,2013-04-21,119.1804257,48.6951597,50.29000092,110,27,21
"229","SLK43_2013_1896",2013,2013-06-22,172,2012-10-06,279,138,2013-05-19,224,2013-05-04,77.52268234,33.63703014,42.34000015,123,15,34
"230","SLK41_2013_1897",2013,2013-07-30,210,2012-09-22,265,138,2013-05-19,238,2013-12-31,78.37709298,33.75357505,45.00999832,364,-226,72
"231","THU65_2012_1859",2012,2012-09-13,256,2011-10-04,276,126,2012-05-06,215,2012-03-11,103.832901,30.00486528,0.917692304,70,56,130
"232","SLK88_2011_1786",2011,2011-07-18,198,2010-10-16,288,103,2011-04-14,180,2011-04-20,86.81308836,33.9541558,39.31999969,109,-6,95
"233","RED55_2011_1787",2011,2011-07-19,199,2010-09-24,266,79,2011-03-21,178,2011-04-19,109.599653,40.71858396,42.34999847,108,-29,120
"234","RED122_2011_1794",2011,2011-07-21,201,2010-09-20,262,79,2011-03-21,182,2011-04-19,135.8947286,51.24048892,50.31999969,108,-29,122
"235","RED26_2011_1806",2011,2011-07-02,182,2010-09-18,260,79,2011-03-21,184,2011-04-19,109.2351364,43.05145224,47.67749786,108,-29,103
"236","SLK70_2011_1807",2011,2011-07-09,189,2010-10-18,290,96,2011-04-07,171,2011-04-20,100.3333131,39.03162491,45.28673862,109,-13,93
"237","RED103_2011_1812",2011,2011-07-17,197,2010-09-14,256,94,2011-04-05,203,2011-04-19,121.0721554,44.47138447,44.74200058,108,-14,103
"238","SLK60_2011_1815",2011,2011-07-09,189,2010-10-18,290,81,2011-03-23,156,2011-04-19,102.7521847,39.65627923,44.88151408,108,-27,108
"239","SLK95_2011_1817",2011,2011-07-19,199,2010-09-19,261,79,2011-03-21,183,2011-03-31,107.8991569,41.02184435,44.24000168,89,-10,120
"240","SLK61_2011_1819",2011,2011-07-07,187,2010-10-02,274,80,2011-03-22,171,2011-03-31,106.9461261,39.35673684,38.7048109,89,-9,107
"241","SLK64_2011_1820",2011,2011-07-07,187,2010-09-24,266,81,2011-03-23,180,2011-03-31,102.3110271,38.01594597,36.59683858,89,-8,106
"242","SLK65_2011_1822",2011,2011-07-05,185,2010-09-05,247,79,2011-03-21,197,2011-04-19,103.8103475,39.29845665,43.2899971,108,-29,106
"243","RED84_2011_1823",2011,2011-07-12,192,2010-09-20,262,80,2011-03-22,183,2011-03-31,99.08830822,36.68653446,35.88819465,89,-9,112
"244","THU33_2011_1829",2011,2011-06-08,158,2010-10-28,300,94,2011-04-05,159,2011-04-20,92.34684132,35.15736958,38.85428619,109,-15,64
"245","THU22_2011_1831",2011,2011-05-20,139,2010-10-17,289,79,2011-03-21,155,2011-04-19,91.56041879,37.42470289,40.31000137,108,-29,60
"246","KEN27_2011_1832",2011,2011-07-10,190,2010-10-01,273,78,2011-03-20,170,2011-12-31,72.16531662,24.16613972,17.14999962,364,-286,112
"247","NIP66_2011_1835",2011,2011-08-01,212,2010-09-26,268,78,2011-03-20,175,2011-04-03,142.4165195,54.07115106,46.52666473,92,-14,134
"248","SAU20_2011_1837",2011,2011-10-09,281,2010-11-21,324,77,2011-03-19,118,2011-03-16,112.2145566,38.79624253,31.15999985,74,3,204
"249","RED23_2011_1795",2011,2011-07-05,185,2010-10-02,274,79,2011-03-21,170,2011-03-31,96.74423675,34.99894798,37.43000031,89,-10,106
"250","SLK38_2011_1798",2011,2011-06-18,168,2010-10-17,289,97,2011-04-08,173,2011-04-20,85.51159364,33.79540873,40.33545559,109,-12,71
"251","RED58_2011_1799",2011,2011-07-07,187,2010-09-20,262,79,2011-03-21,182,2011-04-21,102.1376824,39.09874623,44.02000046,110,-31,108
"252","RED82_2011_1800",2011,2011-07-17,197,2010-10-03,275,79,2011-03-21,169,2011-04-18,101.2270974,37.63800854,40.61605568,107,-28,118
"253","RED85_2011_1818",2011,2011-07-12,192,2010-09-19,261,78,2011-03-20,182,2011-03-26,113.9679412,39.82715609,35.70738189,84,-6,114
"254","SLK35_2011_1821",2011,2011-06-15,165,2010-10-10,282,81,2011-03-23,164,2011-04-19,105.8016854,40.47977353,45.43144543,108,-27,84
"255","THU51_2011_1828",2011,2011-08-01,212,2010-10-31,303,85,2011-03-27,147,2011-04-19,91.5175197,35.18527785,41.02000046,108,-23,127
"256","SLK84_2011_1669",2011,2011-07-16,196,2010-10-19,291,81,2011-03-23,155,2011-04-20,93.6686051,36.03331161,40.65000153,109,-28,115
"257","RED51_2011_1670",2011,2011-07-04,184,2010-10-02,274,79,2011-03-21,170,2011-04-19,129.4497842,47.89122179,45.60444641,108,-29,105
"258","RED36_2011_1671",2011,2011-07-05,185,2010-09-23,265,79,2011-03-21,179,2011-04-19,122.8975565,47.28277028,48.97999954,108,-29,106
"259","RED65_2011_1777",2011,2011-07-18,198,2010-10-02,274,79,2011-03-21,170,2011-03-31,102.4233973,35.13852836,33.45999908,89,-10,119
"260","RED114_2011_1778",2011,2011-07-16,196,2010-09-18,260,79,2011-03-21,184,2011-03-28,123.6683835,43.72792204,42,86,-7,117
"261","RED107_2011_1779",2011,2011-07-18,198,2010-09-28,270,106,2011-04-17,201,2011-05-02,108.7925981,42.78753118,46.95999908,121,-15,92
"262","RED118_2011_1780",2011,2011-07-18,198,2010-09-20,262,82,2011-03-24,185,2011-05-02,106.0969615,40.92720662,46.11000061,121,-39,116
"263","SLK85_2011_1781",2011,2011-07-18,198,2010-09-29,271,104,2011-04-15,198,2011-04-20,86.71233896,34.47277216,34.54000092,109,-5,94
"264","SLK87_2011_1782",2011,2011-07-16,196,2010-09-23,265,113,2011-04-24,213,2011-04-20,77.53569899,30.86452148,35.75,109,4,83
"265","RED100_2011_1783",2011,2011-07-17,197,2010-09-28,270,79,2011-03-21,174,2011-05-02,112.3929749,43.60672826,49.35451998,121,-42,118
"266","RED54_2011_1784",2011,2011-07-17,197,2010-09-24,266,79,2011-03-21,178,2011-05-02,107.7726711,41.94546844,48.47000122,121,-42,118
"267","SLK48_2011_1785",2011,2011-07-04,184,2010-10-17,289,103,2011-04-14,179,2011-04-20,93.68375804,36.40625379,34.90999985,109,-6,81
"268","SLK47_2011_1788",2011,2011-07-03,183,2010-10-20,292,81,2011-03-23,154,2011-04-20,114.2284172,42.94073422,45.3585701,109,-28,102
"269","RED32_2011_1789",2011,2011-07-06,186,2010-10-13,285,79,2011-03-21,159,2011-04-13,133.0226966,50.10445339,47.54999924,102,-23,107
"270","RED123_2011_1790",2011,2011-07-19,199,2010-09-23,265,79,2011-03-21,179,2011-03-31,99.21006176,36.32534358,39.11999893,89,-10,120
"271","NIP40_2011_1791",2011,2011-07-11,191,2010-09-23,265,102,2011-04-13,202,2011-04-20,119.4678099,43.23856932,42.0290532,109,-7,89
"272","RED53_2011_1792",2011,2011-07-07,187,2010-09-20,262,79,2011-03-21,182,2011-04-19,126.7671174,46.50167663,45.74333572,108,-29,108
"273","RED120_2011_1793",2011,2011-07-20,200,2010-10-01,273,79,2011-03-21,171,2011-03-31,93.54225774,33.68029283,35.18999863,89,-10,121
"274","RED24_2011_1796",2011,2011-07-04,184,2010-10-26,298,79,2011-03-21,146,2011-05-02,106.1269293,40.38961891,46.35238266,121,-42,105
"275","RED22_2011_1797",2011,2011-07-03,183,2010-10-21,293,79,2011-03-21,151,2011-05-02,101.3676803,38.67356142,43.72000122,121,-42,104
"276","RED73_2011_1801",2011,2011-07-07,187,2010-09-14,256,79,2011-03-21,188,2011-03-31,98.499211,40.08002622,44.31000137,89,-10,108
"277","RED101_2011_1802",2011,2011-07-10,190,2010-09-23,265,106,2011-04-17,206,2011-04-18,99.03276709,37.32435231,42.22000122,107,-1,84
"278","RED106_2011_1803",2011,2011-07-21,201,2010-09-11,253,79,2011-03-21,191,2011-04-18,106.1567462,40.886031,46.42666626,107,-28,122
"279","RED96_2011_1804",2011,2011-07-18,198,2010-09-17,259,79,2011-03-21,185,2011-04-18,107.1881666,41.5438473,46.8950903,107,-28,119
"280","SLK50_2011_1805",2011,2011-07-16,196,2010-10-19,291,82,2011-03-24,156,2011-04-20,100.4276636,38.600245,43.54571152,109,-27,114
"281","SLK51_2011_1808",2011,2011-07-16,196,2010-10-18,290,81,2011-03-23,156,2011-04-20,106.2352552,40.72891498,45.50999832,109,-28,115
"282","RED29_2011_1809",2011,2011-07-07,187,2010-09-16,258,79,2011-03-21,186,2011-04-19,111.7279748,43.26019195,46.04098054,108,-29,108
"283","SLK76_2011_1810",2011,2011-07-15,195,2010-09-20,262,82,2011-03-24,185,2011-04-19,96.2885228,37.16844089,44.59000015,108,-26,113
"284","NIP55_2011_1811",2011,2011-07-21,201,2010-10-10,282,81,2011-03-23,164,2011-04-20,118.6833789,43.32448421,42.72000122,109,-28,120
"285","RED50_2011_1813",2011,2011-07-16,196,2010-09-23,265,79,2011-03-21,179,2011-04-19,131.4458793,48.71019185,47.38999939,108,-29,117
"286","RED52_2011_1814",2011,2011-07-06,186,2010-09-23,265,79,2011-03-21,179,2011-04-19,125.1119985,46.1624643,45.83889008,108,-29,107
"287","RED72_2011_1816",2011,2011-07-18,198,2010-10-17,289,79,2011-03-21,155,2011-03-31,96.74598133,33.54776125,32.56999969,89,-10,119
"288","SLK82_2011_1824",2011,2011-07-15,195,2010-09-23,265,95,2011-04-06,195,2011-04-20,114.3727483,42.31026133,41.59000015,109,-14,100
"289","THU58_2011_1825",2011,2011-07-30,210,2010-09-18,260,79,2011-03-21,184,2011-04-19,93.49137167,36.40186599,39.13999939,108,-29,131
"290","THU50_2011_1826",2011,2011-07-23,203,2010-10-04,276,82,2011-03-24,171,2011-04-19,92.36985267,35.05834244,37.88999939,108,-26,121
"291","COC25_2011_1827",2011,2011-08-10,221,2010-10-18,290,80,2011-03-22,155,2011-04-20,164.340535,67.96401724,74.84999847,109,-29,141
"292","THU80_2011_1830",2011,2011-09-04,246,2010-10-03,275,79,2011-03-21,169,2011-04-19,91.08188071,35.97619019,39.83000183,108,-29,167
"293","FOR42_2011_1834",2011,2011-08-29,240,2010-09-19,261,76,2011-03-18,180,2011-12-31,60.13869792,18.67581524,13.72000027,364,-288,164
"294","FOR17_2011_1836",2011,2011-07-21,201,2010-10-24,296,76,2011-03-18,145,2011-03-14,55.2625625,18.60502768,13.77999973,72,4,125
"295","RED7_2009_1725",2009,2009-06-18,168,2008-10-05,278,75,2009-03-17,162,2009-04-11,81.95612261,25.56847749,21.33857155,100,-25,93
"296","SLK25_2009_1726",2009,2009-06-26,176,2008-09-19,262,90,2009-04-01,193,2009-04-11,91.32716983,29.62258414,22.89999962,100,-10,86
"297","SLK24_2009_1727",2009,2009-06-25,175,2008-09-10,253,91,2009-04-02,203,2009-04-01,90.53361509,29.52898196,23.69000053,90,1,84
"298","KEN28_2015_1959",2015,2015-05-24,143,2014-11-21,324,86,2015-03-28,127,2015-03-09,84.61957722,27.59299207,14.91666698,67,19,57
"299","RED10_2015_1960",2015,2015-05-28,147,2014-10-08,280,110,2015-04-21,195,2015-03-30,81.29632848,30.16468591,27.60000038,88,22,37
"300","COC12_2015_1961",2015,2015-06-29,179,2014-10-01,273,122,2015-05-03,214,2015-04-09,163.7369958,67.31642546,71.31999969,98,24,57
"301","SUD38_2015_1970",2015,2015-07-31,211,2014-10-12,284,110,2015-04-21,191,2015-04-01,128.12829,46.88325118,49.6166687,90,20,101
"302","KEN5_2015_1971",2015,2015-04-16,105,2014-10-21,293,90,2015-04-01,162,2015-03-09,59.64209288,18.5444885,11.10000038,67,23,15
"303","RED50_2015_1999",2015,2015-07-12,192,2014-11-06,309,110,2015-04-21,166,2015-03-09,56.94951937,18.23334988,11.64999962,67,43,82
"304","NIP38_2015_1995",2015,2015-06-26,176,2014-10-07,279,123,2015-05-04,209,2015-04-08,92.5145922,34.84090921,32.93500137,97,26,53
"305","SLK32_2015_1980",2015,2015-06-27,177,2014-09-17,259,110,2015-04-21,216,2015-04-07,63.55585255,19.13883332,19.10499954,96,14,67
"306","RED7_2015_1998",2015,2015-05-28,147,2014-10-08,280,110,2015-04-21,195,2015-03-20,71.59759324,24.57542275,14.69999981,78,32,37
"307","RED59_2015_1962",2015,2015-07-08,188,2014-09-07,249,122,2015-05-03,238,2015-04-08,33.9691576,8.011868508,4.579999924,97,25,66
"308","SLK55_2015_1963",2015,2015-07-11,191,2014-09-07,249,130,2015-05-11,246,2015-04-08,52.9700058,15.30118146,14.83625031,97,33,61
"309","NIP20_2015_1965",2015,2015-06-09,159,2014-10-07,279,111,2015-04-22,197,2015-04-08,76.24215404,29.57735448,28.68000031,97,14,48
"310","RED24_2015_1966",2015,2015-06-26,176,2014-11-12,315,109,2015-04-20,159,2015-03-09,56.07306554,17.88475641,14.6257143,67,42,67
"311","SLK19_2015_1967",2015,2015-06-09,159,2014-09-16,258,121,2015-05-02,228,2015-04-08,74.67849562,24.49267471,22.52000046,97,24,38
"312","RED44_2015_1968",2015,2015-07-16,196,2014-10-31,303,110,2015-04-21,172,2015-03-09,51.58806527,16.54301869,14.02000046,67,43,86
"313","SLK53_2015_1969",2015,2015-07-09,189,2014-09-18,260,110,2015-04-21,215,2015-04-07,76.59578433,22.97207768,17.1483345,96,14,79
"314","NIP31_2015_1972",2015,2015-07-01,181,2014-09-16,258,123,2015-05-04,230,2015-04-08,84.66409359,32.24518825,31.36999893,97,26,58
"315","NIP32_2015_1973",2015,2015-07-01,181,2014-10-13,285,110,2015-04-21,190,2015-04-08,90.40451658,34.12940425,31.88999939,97,13,71
"316","SLK23_2015_1974",2015,2015-06-27,177,2014-09-07,249,110,2015-04-21,226,2015-04-08,113.8513189,43.51919095,45.34000015,97,13,67
"317","SLK30_2015_1975",2015,2015-07-01,181,2014-09-17,259,112,2015-04-23,218,2015-04-08,105.9332419,39.18882792,39.72999954,97,15,69
"318","NIP24_2015_1976",2015,2015-07-03,183,2014-10-07,279,120,2015-05-01,206,2015-04-08,92.46360442,34.75815646,32.7519989,97,23,63
"319","COC13_2015_1977",2015,2015-06-23,173,2014-10-20,292,111,2015-04-22,184,2015-04-09,118.2661642,48.50666568,50.75,98,13,62
"320","NIP23_2015_1979",2015,2015-06-22,172,2014-10-05,277,117,2015-04-28,205,2015-04-08,76.90654055,28.14977907,26.63750076,97,20,55
"321","SLK21_2015_1981",2015,2015-06-28,178,2014-10-12,284,110,2015-04-21,191,2015-04-07,99.10002726,34.39197352,34.12250137,96,14,68
"322","SLK67_2015_1982",2015,2015-07-15,195,2014-09-15,257,126,2015-05-07,234,2015-04-08,53.96325781,15.87956944,16.16181755,97,29,69
"323","RED25_2015_1983",2015,2015-07-04,184,2014-10-08,280,109,2015-04-20,194,2015-03-09,45.71283294,13.54506582,5.809999943,67,42,75
"324","NIP19_2015_1984",2015,2015-06-08,158,2014-09-17,259,121,2015-05-02,227,2015-04-08,73.33630613,26.1174285,25.26799965,97,24,37
"325","SLK36_2015_1985",2015,2015-06-29,179,2014-09-11,253,114,2015-04-25,226,2015-04-08,94.83379592,34.56018928,32.79999924,97,17,65
"326","RED11_2015_1986",2015,2015-05-27,146,2014-09-03,245,119,2015-04-30,239,2015-03-30,83.05233836,30.12913835,25.80999947,88,31,27
"327","RED58_2015_1987",2015,2015-07-15,195,2014-11-03,306,110,2015-04-21,169,2015-04-07,31.4469441,5.994316538,2.5,96,14,85
"328","SLK62_2015_1988",2015,2015-07-15,195,2014-10-06,278,121,2015-05-02,208,2015-04-08,66.92661089,22.47595303,21.82999992,97,24,74
"329","SLK41_2015_1989",2015,2015-06-30,180,2014-09-11,253,110,2015-04-21,222,2015-04-07,88.62589366,30.78362677,31.22999954,96,14,70
"330","NIP30_2015_1990",2015,2015-06-29,179,2014-10-07,279,111,2015-04-22,197,2015-04-08,89.68274719,34.14908184,31.38333321,97,14,68
"331","NIP17_2015_1991",2015,2015-06-22,172,2014-10-07,279,114,2015-04-25,200,2015-04-08,67.18759312,24.82354509,26.05038267,97,17,58
"332","SLK28_2015_1992",2015,2015-06-27,177,2014-10-05,277,110,2015-04-21,198,2015-04-07,113.3799374,40.43052365,37.75666428,96,14,67
"333","RED17_2015_1993",2015,2015-06-18,168,2014-10-05,277,110,2015-04-21,198,2015-04-07,22.10399051,4.780243343,2.829999924,96,14,58
"334","RED16_2015_1994",2015,2015-06-18,168,2014-10-19,291,110,2015-04-21,184,2015-04-07,25.61168137,4.78241158,2.180000067,96,14,58
"335","RED46_2015_1996",2015,2015-07-02,182,2014-11-03,306,110,2015-04-21,169,2015-03-09,55.57790779,17.62650906,14.72999954,67,43,72
"336","SLK57_2015_1997",2015,2015-07-11,191,2014-10-07,279,110,2015-04-21,196,2015-04-07,65.46039089,19.7648235,19.23999977,96,14,81
"337","SLK26_2017_2089",2017,2017-07-27,207,2016-10-10,283,126,2017-05-07,208,2017-04-29,185.0748683,69.62299969,81.27000427,118,8,81
"338","NIP99_2017_2094",2017,2017-08-14,225,2016-11-08,312,121,2017-05-02,174,2017-04-27,194.1159033,74.98894263,83.55000305,116,5,104
"339","SLK237_2017_1939",2017,2017-10-19,291,2016-10-13,286,119,2017-04-30,198,2017-04-29,221.6396146,85.11894188,104.435997,118,1,172
"340","SLK45_2017_1940",2017,2017-07-31,211,2016-09-09,252,119,2017-04-30,232,2017-03-25,160.2557477,52.79487433,53.48500061,83,36,92
"341","RED23_2017_1941",2017,2017-07-29,209,2016-09-19,262,111,2017-04-22,214,2017-12-31,36.02601254,7.587306731,0,364,-253,98
"342","NIP78_2017_1942",2017,2017-08-08,219,2016-09-22,265,127,2017-05-08,227,2017-04-30,229.322652,92.07293921,109.7860031,119,8,92
"343","NIP37_2017_1945",2017,2017-07-31,211,2016-10-13,286,127,2017-05-08,206,2017-04-30,196.2819061,79.05070921,90.76593218,119,8,84
"344","SLK187_2017_1946",2017,2017-08-18,229,2016-09-26,269,127,2017-05-08,223,2017-04-28,114.6229878,41.82315331,23.55500031,117,10,102
"345","SLK8_2017_1947",2017,2017-07-14,194,2016-10-17,290,123,2017-05-04,198,2017-03-25,121.0362323,42.54829679,31.96500015,83,40,71
"346","SLK32_2017_1948",2017,2017-07-29,209,2016-10-09,282,119,2017-04-30,202,2017-03-25,78.39452441,15.61805003,3.140000105,83,36,90
"347","SLK42_2017_1949",2017,2017-07-29,209,2016-10-08,281,127,2017-05-08,211,2017-04-29,238.038336,95.08289066,114.8733368,118,9,82
"348","SLK36_2017_1950",2017,2017-08-01,212,2016-10-10,283,119,2017-04-30,201,2017-04-29,242.7105872,95.70582045,108.4000015,118,1,93
"349","SLK129_2017_1951",2017,2017-08-11,222,2016-10-07,280,133,2017-05-14,218,2017-03-25,129.8104315,45.38522917,43.86000061,83,50,89
"350","NIP12_2017_1952",2017,2017-07-07,187,2016-10-17,290,130,2017-05-11,205,2017-04-27,143.2775434,49.49800641,50.93499756,116,14,57
"351","NIP40_2017_1953",2017,2017-07-30,210,2016-09-23,266,120,2017-05-01,219,2017-04-30,215.1231203,86.00940245,103.1999969,119,1,90
"352","NIP75_2017_1954",2017,2017-08-11,222,2016-10-21,294,126,2017-05-07,197,2017-04-27,229.615304,93.14013527,108.1800003,116,10,96
"353","NIP46_2017_1955",2017,2017-08-29,240,2016-10-22,295,124,2017-05-05,194,2017-04-30,195.3509767,76.37988622,89.62000275,119,5,116
"354","SLK102_2017_1956",2017,2017-08-13,224,2016-10-13,286,119,2017-04-30,198,2017-04-29,129.0167491,46.59513228,34.15000153,118,1,105
"355","NIP64_2017_1957",2017,2017-08-12,223,2016-10-02,275,127,2017-05-08,217,2017-04-30,166.9104827,64.91017909,70.58499908,119,8,96
"356","SLK115_2017_2023",2017,2017-08-12,223,2016-09-14,257,119,2017-04-30,227,2017-04-29,146.0063171,55.28606696,59.98500061,118,1,104
"357","NIP32_2017_2024",2017,2017-07-30,210,2016-09-04,247,128,2017-05-09,246,2017-04-28,243.9930573,99.16466925,114.8249969,117,11,82
"358","RED34_2017_2025",2017,2017-08-07,218,2016-09-27,270,117,2017-04-28,212,2017-03-22,74.33827281,13.4617695,0.023609467,80,37,101
"359","SLK200_2017_2026",2017,2017-08-25,236,2016-10-13,286,127,2017-05-08,206,2017-04-29,208.1289927,81.59410943,100.4919968,118,9,109
"360","NIP54_2017_2027",2017,2017-08-14,225,2016-09-11,254,120,2017-05-01,231,2017-04-30,190.1926989,74.81099884,87.63600159,119,1,105
"361","SLK175_2017_2072",2017,2017-09-02,244,2016-10-12,285,127,2017-05-08,207,2017-04-29,133.9847033,49.23835549,48.14500046,118,9,117
"362","THU58_2017_2073",2017,2017-09-13,255,2016-10-10,283,126,2017-05-07,208,2017-04-29,258.8907315,104.7028342,122.9466705,118,8,129
"363","SLK96_2017_2074",2017,2017-08-09,220,2016-09-14,257,127,2017-05-08,235,2017-04-30,150.8409218,57.9643025,68.72999573,119,8,93
"364","SLK43_2017_2075",2017,2017-07-31,211,2016-09-28,271,126,2017-05-07,220,2017-04-29,214.9299303,82.49333107,101.406662,118,8,85
"365","SLK82_2017_2076",2017,2017-08-08,219,2016-09-14,257,119,2017-04-30,227,2017-04-29,145.3482518,54.73294339,50.14500046,118,1,100
"366","SLK23_2017_2077",2017,2017-07-29,209,2016-10-09,282,123,2017-05-04,206,2017-04-29,162.9058824,59.94080875,59.46500015,118,5,86
"367","NIP29_2017_2078",2017,2017-08-06,217,2016-10-10,283,127,2017-05-08,209,2017-04-30,147.5008073,56.82942849,66.51234101,119,8,90
"368","NIP77_2017_2079",2017,2017-08-12,223,2016-10-13,286,127,2017-05-08,206,2017-04-30,240.4709279,97.66470143,116.1100006,119,8,96
"369","NIP68_2017_2080",2017,2017-08-12,223,2016-10-17,290,127,2017-05-08,202,2017-04-28,230.233827,93.01779043,104.2866669,117,10,96
"370","SLK122_2017_2081",2017,2017-08-13,224,2016-10-17,290,127,2017-05-08,202,2017-04-29,143.8438217,52.43543427,63.06699753,118,9,97
"371","SLK157_2017_2082",2017,2017-08-14,225,2016-09-14,257,127,2017-05-08,235,2017-04-29,128.8468718,46.51332305,40.81999969,118,9,98
"372","SLK44_2017_2083",2017,2017-07-30,210,2016-10-12,285,119,2017-04-30,199,2017-04-29,198.4312892,73.49511348,95.43000031,118,1,91
"373","NIP73_2017_2084",2017,2017-07-30,210,2016-10-21,294,127,2017-05-08,198,2017-04-28,235.9361331,94.80139413,110.8199997,117,10,83
"374","THU59_2017_2085",2017,2017-09-14,256,2016-10-09,282,124,2017-05-05,207,2017-04-29,290.7726666,119.3804078,137.625,118,6,132
"375","SLK64_2017_2086",2017,2017-08-05,216,2016-10-04,277,119,2017-04-30,207,2017-03-25,142.3403419,47.67960903,42.05999756,83,36,97
"376","THU61_2017_2087",2017,2017-09-12,254,2016-09-27,270,126,2017-05-07,221,2017-04-29,282.4645967,115.2458255,130.8500061,118,8,128
"377","RED87_2017_2088",2017,2017-08-13,224,2016-09-14,257,119,2017-04-30,227,2017-03-25,88.39369503,18.19461247,2.24666667,83,36,105
"378","NIP9_2017_2090",2017,2017-07-07,187,2016-10-12,285,127,2017-05-08,207,2017-04-30,241.5500588,99.33444209,116.7971208,119,8,60
"379","NIP39_2017_2091",2017,2017-08-05,216,2016-09-11,254,127,2017-05-08,238,2017-04-30,198.4443528,78.96186052,91.45999908,119,8,89
"380","RED69_2017_2092",2017,2017-08-26,237,2016-10-09,282,118,2017-04-29,201,2017-03-22,72.6072611,12.99633685,0.023942858,80,38,119
"381","THU31_2017_2093",2017,2017-08-03,214,2016-09-10,253,143,2017-05-24,255,2017-04-29,265.2865704,107.0183781,122.9979172,118,25,71
"382","SLK103_2017_2095",2017,2017-08-12,223,2016-09-14,257,127,2017-05-08,235,2017-04-28,115.8106791,42.51351919,24.93000031,117,10,96
"383","SLK63_2017_2096",2017,2017-08-04,215,2016-09-08,251,119,2017-04-30,233,2017-04-29,149.6004677,56.42876328,55.81999969,118,1,96
"384","NIP98_2017_2097",2017,2017-08-12,223,2016-10-13,286,127,2017-05-08,206,2017-04-30,168.0593259,65.60811565,69.70869336,119,8,96
"385","RED56_2017_2098",2017,2017-07-30,210,2016-09-19,262,119,2017-04-30,222,2017-03-22,64.16777885,10.51889831,0,80,39,91
"386","SLK7_2017_2099",2017,2017-07-12,192,2016-11-05,309,119,2017-04-30,175,2017-03-25,102.1427057,22.31657536,3.908333302,83,36,73
"387","SLK162_2017_2100",2017,2017-08-16,227,2016-10-13,286,119,2017-04-30,198,2017-04-29,146.918672,54.683117,53.43499756,118,1,108
"388","SLK68_2017_2101",2017,2017-08-13,224,2016-10-14,287,119,2017-04-30,197,2017-04-29,158.8146247,61.26160899,75.54000092,118,1,105
"389","RED103_2017_2102",2017,2017-08-15,226,2016-10-13,286,119,2017-04-30,198,2017-03-22,72.77991352,13.10541437,0.027942857,80,39,107
"390","NIP65_2017_2103",2017,2017-08-12,223,2016-10-13,286,127,2017-05-08,206,2017-04-30,166.5292513,64.72652089,69.64500427,119,8,96
"391","NIP11_2017_2104",2017,2017-07-06,186,2016-11-12,316,126,2017-05-07,175,2017-04-30,179.8935238,70.00011482,74.79000092,119,7,60
"392","SLK38_2017_2105",2017,2017-08-12,223,2016-09-09,252,127,2017-05-08,240,2017-04-29,242.670072,97.09794021,116.9149933,118,9,96
"393","SLK33_2017_2106",2017,2017-07-28,208,2016-09-11,254,127,2017-05-08,238,2017-04-29,198.7255864,74.09347575,94.6866684,118,9,81
"394","SLK17_2017_2107",2017,2017-07-29,209,2016-10-09,282,119,2017-04-30,202,2017-04-29,159.2229121,57.51347418,56.86942621,118,1,90
"395","SLK52_2017_2110",2017,2017-08-13,224,2016-10-17,290,119,2017-04-30,194,2017-04-29,221.1992674,86.63287822,105.1600037,118,1,105
"396","NIP38_2017_2111",2017,2017-07-30,210,2016-10-13,286,127,2017-05-08,206,2017-04-30,195.5388837,78.19926079,89.93000031,119,8,83
"397","NIP105_2017_2112",2017,2017-08-12,223,2016-09-15,258,132,2017-05-13,239,2017-05-09,144.7624588,48.81844067,42.65777969,128,4,91
"398","RED54_2017_2113",2017,2017-08-13,224,2016-11-22,326,114,2017-04-25,153,2017-03-18,65.54936177,20.13255743,1.95875001,76,38,110
"399","SLK37_2020_2160",2020,2020-07-25,206,2019-10-13,285,96,2020-04-06,176,2020-04-22,108.6850248,39.59713901,28.50249863,112,-16,110
"400","THU4_2020_2161",2020,2020-05-14,134,2019-09-29,271,93,2020-04-03,187,2020-03-27,115.5578415,45.18404985,19.03000069,86,7,41
"401","RED12_2020_2194",2020,2020-06-18,169,2019-09-28,270,112,2020-04-22,207,2020-04-22,86.29681186,33.89845487,18.54000092,112,0,57
"402","NIP47_2020_2196",2020,2020-08-11,223,2019-10-08,280,106,2020-04-16,191,2020-04-23,181.9701292,75.7443029,82.58999634,113,-7,117
"403","SLK26_2020_2197",2020,2020-07-20,201,2019-10-08,280,132,2020-05-12,217,2020-04-23,102.9209066,39.43933254,32.80500031,113,19,69
"404","RED8_2020_2198",2020,2020-06-17,168,2019-10-25,297,112,2020-04-22,180,2020-04-22,78.17636232,25.40247401,13.36999989,112,0,56
"405","RED24_2020_2199",2020,2020-07-04,185,2019-09-28,270,112,2020-04-22,207,2020-04-22,80.54021714,25.64662562,11.59000015,112,0,73
"406","SLK36_2020_2200",2020,2020-07-26,207,2019-10-07,279,107,2020-04-17,193,2020-04-22,98.05473132,34.90271868,26.80999947,112,-5,100
"407","SLK25_2020_2201",2020,2020-07-20,201,2019-10-08,280,131,2020-05-11,216,2020-04-23,99.03777636,38.1104815,30.03499985,113,18,70
"408","NIP30_2020_2202",2020,2020-07-10,191,2019-10-07,279,106,2020-04-16,192,2020-04-23,156.3793775,63.05323761,63.30500031,113,-7,85
"409","NIP46_2020_2203",2020,2020-08-09,221,2019-10-04,276,106,2020-04-16,195,2020-04-23,171.0681982,69.87281623,71.65000153,113,-7,115
"410","RED29_2020_2204",2020,2020-07-10,191,2019-10-09,281,113,2020-04-23,197,2020-04-22,81.58628626,27.3751154,12.92000008,112,1,78
"411","SLK3_2020_2205",2020,2020-06-17,168,2019-10-03,275,112,2020-04-22,202,2020-04-22,62.49551541,23.91501762,19.31999969,112,0,56
"412","NIP51_2020_2206",2020,2020-08-09,221,2019-09-16,258,113,2020-04-23,220,2020-04-23,141.8170382,55.67750446,56.65000153,113,0,108
"413","NIP26_2020_2207",2020,2020-07-10,191,2019-10-16,288,132,2020-05-12,209,2020-04-23,91.12476153,37.02383325,35.52833557,113,19,59
"414","NIP45_2020_2208",2020,2020-08-11,223,2019-10-13,285,110,2020-04-20,190,2020-04-23,141.1358495,56.41402562,50.20500183,113,-3,113
"415","RED49_2020_2210",2020,2020-08-12,224,2019-10-13,285,94,2020-04-04,174,2020-04-05,39.02423835,13.12634547,3.944999933,95,-1,130
"416","CHA3_2020_2213",2020,2020-07-03,184,2019-09-24,266,73,2020-03-14,172,2020-03-27,166.1363249,64.6836894,59.59000015,86,-13,111
"417","SLK48_2020_2214",2020,2020-08-09,221,2019-09-27,269,131,2020-05-11,227,2020-04-22,102.3836782,37.76394129,28.13916588,112,19,90
"418","RED9_2020_2216",2020,2020-06-17,168,2019-10-02,274,112,2020-04-22,203,2020-04-06,93.78355123,36.07908388,15.68000031,96,16,56
"419","SLK47_2020_2217",2020,2020-08-09,221,2019-10-07,279,132,2020-05-12,218,2020-04-22,111.1976599,39.89633563,33.40000153,112,20,89
"420","RED30_2020_2218",2020,2020-06-08,159,2019-10-18,290,112,2020-04-22,187,2020-04-22,81.82324176,26.77397314,12.74200058,112,0,47
"421","RED22_2020_2195",2020,2020-07-08,189,2019-10-04,276,112,2020-04-22,201,2020-04-22,95.57345945,33.25345667,15.3039999,112,0,77
"422","RED18_2020_2209",2020,2020-07-06,187,2019-10-17,289,115,2020-04-25,191,2020-04-22,98.90731602,35.24661329,19.85000038,112,3,72
"423","NIP40_2020_2211",2020,2020-08-07,219,2019-09-27,269,133,2020-05-13,229,2020-04-22,161.0671303,67.32644448,51.11000061,112,21,86
"424","COC11_2020_2212",2020,2020-08-07,219,2019-10-18,290,130,2020-05-10,205,2020-04-23,89.93257228,35.69513216,29.78000069,113,17,89
"425","COC12_2020_2215",2020,2020-07-24,205,2019-09-08,250,131,2020-05-11,246,2020-04-23,82.93277971,32.96486346,28.25,113,18,74
"426","NOR68_2018_2028",2018,2018-07-10,190,2017-11-04,307,120,2018-05-01,178,2018-04-15,150.9242255,56.57062765,36.40999985,104,16,70
"427","RED110_2018_2030",2018,2018-07-19,199,2017-09-28,270,117,2018-04-28,212,2018-12-31,88.51959884,32.0831612,28.5354538,364,-247,82
"428","PEM7_2018_2038",2018,2018-07-19,199,2017-09-08,250,118,2018-04-29,233,2018-04-15,124.2709827,44.34005536,21.46999931,104,14,81
"429","NOR56_2018_2044",2018,2018-07-06,186,2017-11-21,324,124,2018-05-05,165,2018-04-15,148.1112558,56.37864401,49.51600266,104,20,62
"430","TIM6_2018_2045",2018,2018-06-28,178,2017-09-30,272,127,2018-05-08,220,2018-04-19,174.9454624,74.5893984,72.65999603,108,19,51
"431","NIP5_2018_2048",2018,2018-05-25,144,2017-09-04,246,131,2018-05-12,250,2018-05-02,92.32480392,43.42555854,49.20000076,121,10,13
"432","NOR62_2018_2053",2018,2018-07-09,189,2017-11-11,314,120,2018-05-01,171,2018-04-15,154.1352092,55.92806345,42.20000076,104,16,69
"433","KEN71_2018_2063",2018,2018-07-17,197,2017-10-16,288,108,2018-04-19,185,2018-03-03,46.02048291,16.60209386,8.229999542,61,47,89
"434","NIP10_2018_2066",2018,2018-06-14,164,2017-09-07,249,133,2018-05-14,249,2018-04-20,113.6664916,57.5048,69.48999786,109,24,31
"435","PAR33_2018_2071",2018,2018-07-20,200,2017-11-01,304,107,2018-04-18,168,2018-03-30,72.93238473,24.84104996,7.429999828,88,19,93
"436","SLK117_2018_2117",2018,2018-07-13,193,2017-09-30,272,124,2018-05-05,217,2018-12-31,101.3326678,46.53471026,51.08000183,364,-240,69
"437","NOR69_2018_2119",2018,2018-07-06,186,2017-11-18,321,127,2018-05-08,171,2018-04-15,141.0428956,52.39681591,43.49142838,104,23,59
"438","NOR25_2018_2121",2018,2018-07-01,181,2017-09-28,270,110,2018-04-21,205,2018-04-15,141.9440153,50.20150106,36.86999893,104,6,71
"439","SUD83_2018_2125",2018,2018-07-01,181,2017-11-11,314,118,2018-04-29,169,2018-04-15,158.5026016,53.56597328,42.00999832,104,14,63
"440","SLK49_2018_2128",2018,2018-07-08,188,2017-09-08,250,131,2018-05-12,246,2018-12-31,84.54708242,34.40042265,36.68999863,364,-233,57
"441","NOR42_2018_2129",2018,2018-07-01,181,2017-11-11,314,110,2018-04-21,161,2018-04-15,148.6143421,53.46464372,41.25,104,6,71
"442","KEN77_2018_2140",2018,2018-07-20,200,2017-09-25,267,114,2018-04-25,212,2018-03-03,43.62308059,17.22303736,11.46000004,61,53,86
"443","COC8_2018_2145",2018,2018-07-16,196,2017-11-15,318,133,2018-05-14,180,2018-04-22,193.2856663,84.86469211,84.62110901,111,22,63
"444","RED60_2018_2150",2018,2018-06-29,179,2017-09-19,261,110,2018-04-21,214,2018-12-31,53.68365273,23.48171762,22.44000053,364,-254,69
"445","NIP24_2018_2151",2018,2018-06-27,177,2017-11-09,312,131,2018-05-12,184,2018-04-19,100.6175027,49.62199423,57.26333237,108,23,46
"446","TIM12_2018_2153",2018,2018-07-13,193,2017-11-15,318,124,2018-05-05,171,2018-04-16,156.6484228,64.59738866,60.81999969,105,19,69
"447","RED115_2018_2156",2018,2018-07-16,196,2017-11-11,314,124,2018-05-05,175,2018-12-31,83.72801791,23.31904687,18.54000092,364,-240,72
"448","NOR72_2018_2035",2018,2018-07-10,190,2017-11-04,307,124,2018-05-05,182,2018-04-15,149.6513307,57.9575385,51.22349105,104,20,66
"449","NIP29_2018_2055",2018,2018-07-11,191,2017-10-09,281,128,2018-05-09,212,2018-04-20,89.44686141,43.85693827,50.90000153,109,19,63
"450","COC14_2018_2126",2018,2018-07-20,200,2017-11-01,304,132,2018-05-13,193,2018-04-22,178.6584076,82.47686777,78.87999725,111,21,68
"451","RED38_2018_2029",2018,2018-06-19,169,2017-10-11,283,114,2018-04-25,196,2018-03-24,20.37625874,6.08341315,6.210000038,82,32,55
"452","NIP13_2018_2031",2018,2018-06-21,171,2017-11-02,305,130,2018-05-11,190,2018-04-21,109.0671525,54.32594186,66.86000061,110,20,41
"453","RED30_2018_2032",2018,2018-05-23,142,2017-10-14,286,110,2018-04-21,189,2018-05-03,56.37070666,26.5275958,29.29999924,122,-12,32
"454","RED108_2018_2033",2018,2018-07-15,195,2017-11-20,323,108,2018-04-19,150,2018-12-31,50.78474817,16.49017522,15.30300045,364,-256,87
"455","NIP37_2018_2034",2018,2018-07-16,196,2017-11-11,314,120,2018-05-01,171,2018-04-19,97.6165138,48.47334165,55.34999847,108,12,76
"456","THU52_2018_2036",2018,2018-08-13,224,2017-10-14,286,120,2018-05-01,199,2018-12-31,117.7281122,47.41193864,48.39500046,364,-244,104
"457","NIP40_2018_2037",2018,2018-07-17,197,2017-09-08,250,127,2018-05-08,242,2018-04-20,103.6664046,52.40632369,65.05999756,109,18,70
"458","FOR24_2018_2039",2018,2018-08-24,235,2017-11-11,314,109,2018-04-20,160,2018-04-17,109.6200663,44.21380874,38.5,106,3,126
"459","RED82_2018_2040",2018,2018-07-17,197,2017-10-10,282,108,2018-04-19,191,2018-08-21,34.48023925,14.80828206,16.44000053,232,-124,89
"460","COC20_2018_2041",2018,2018-07-20,200,2017-10-30,302,120,2018-05-01,183,2018-04-22,167.6153126,70.70546596,62.72000122,111,9,80
"461","HEA12_2018_2042",2018,2018-07-16,196,2017-10-30,302,115,2018-04-26,178,2018-04-22,175.5618465,76.31017342,68.94000244,111,4,81
"462","SLK44_2018_2043",2018,2018-07-12,192,2017-10-11,283,120,2018-05-01,202,2018-04-19,97.77950909,48.50845321,54.11999893,108,12,72
"463","SLK51_2018_2046",2018,2018-07-08,188,2017-10-20,292,124,2018-05-05,197,2018-12-31,80.67036113,28.32218224,30.38999939,364,-240,64
"464","SLK48_2018_2047",2018,2018-07-12,192,2017-10-04,276,118,2018-04-29,207,2018-12-31,81.42810586,35.25001076,37.45000076,364,-246,74
"465","RED80_2018_2049",2018,2018-07-19,199,2017-10-10,282,108,2018-04-19,191,2018-12-31,43.99800532,16.06289571,16.52000046,364,-256,91
"466","NIP32_2018_2050",2018,2018-07-11,191,2017-10-14,286,120,2018-05-01,199,2018-05-02,82.86717165,38.8730326,46.27000046,121,-1,71
"467","THU36_2018_2051",2018,2018-07-29,209,2017-11-02,305,118,2018-04-29,178,2018-12-31,113.0737549,47.80833544,50.47000122,364,-246,91
"468","RED170_2018_2052",2018,2018-05-25,144,2017-11-09,312,110,2018-04-21,163,2018-09-10,53.49538918,24.29469898,24.83606748,252,-142,34
"469","SLK19_2018_2054",2018,2018-06-19,169,2017-11-09,312,114,2018-04-25,167,2018-03-30,23.09004076,9.190376318,7.980000019,88,26,55
"470","SLK23_2018_2056",2018,2018-06-19,169,2017-10-20,292,114,2018-04-25,187,2018-12-31,50.83639951,12.95838969,10.28999996,364,-250,55
"471","NIP27_2018_2057",2018,2018-06-27,177,2017-11-04,307,127,2018-05-08,185,2018-04-19,98.88348157,49.24639846,55.59999847,108,19,50
"472","SLK37_2018_2058",2018,2018-06-28,178,2017-09-26,268,131,2018-05-12,228,2018-12-31,39.11309146,11.53196437,9,364,-233,47
"473","NIP31_2018_2059",2018,2018-07-10,190,2017-10-10,282,128,2018-05-09,211,2018-04-20,109.469276,55.30676296,67.17799377,109,19,62
"474","RED86_2018_2060",2018,2018-07-19,199,2017-10-28,300,108,2018-04-19,173,2018-12-31,39.55619608,16.51543258,18.76000023,364,-256,91
"475","RED103_2018_2061",2018,2018-07-15,195,2017-11-09,312,111,2018-04-22,164,2018-12-31,47.0710059,16.95136779,16.35000038,364,-253,84
"476","SLK57_2018_2062",2018,2018-07-11,191,2017-09-29,271,128,2018-05-09,222,2018-04-19,81.85529626,40.27537801,43.88892516,108,20,63
"477","RED97_2018_2064",2018,2018-07-20,200,2017-10-10,282,111,2018-04-22,194,2018-12-31,44.01394367,15.99153245,16.29999924,364,-253,89
"478","SLK68_2018_2065",2018,2018-07-16,196,2017-09-19,261,116,2018-04-27,220,2018-12-31,94.62496701,44.48589557,49.25999832,364,-248,80
"479","SLK53_2018_2067",2018,2018-07-08,188,2017-09-07,249,133,2018-05-14,249,2018-04-19,77.95186422,38.79240537,42.29000092,108,25,55
"480","SLK18_2018_2068",2018,2018-06-26,176,2017-10-11,283,114,2018-04-25,196,2018-12-31,54.67468786,18.25602495,20.45000076,364,-250,62
"481","NOR46_2018_2069",2018,2018-07-02,182,2017-11-01,304,110,2018-04-21,171,2018-04-15,130.8970184,48.98490752,45.88749695,104,6,72
"482","RED67_2018_2070",2018,2018-07-13,193,2017-09-15,257,110,2018-04-21,218,2018-03-24,54.12655912,23.98302194,24.37000084,82,28,83
"483","NIP30_2018_2115",2018,2018-07-10,190,2017-10-08,280,123,2018-05-04,208,2018-04-29,89.56217446,43.57142503,52.69968703,118,5,67
"484","RED96_2018_2116",2018,2018-07-19,199,2017-10-14,286,111,2018-04-22,190,2018-12-31,40.22815896,15.82644753,16.28000069,364,-253,88
"485","SLK56_2018_2118",2018,2018-07-12,192,2017-10-14,286,129,2018-05-10,208,2018-12-31,61.50199538,14.78516965,14.46000004,364,-235,63
"486","NIP53_2018_2122",2018,2018-07-22,202,2017-11-09,312,130,2018-05-11,183,2018-04-19,96.83891502,47.91571336,53.50999832,108,22,72
"487","SLK67_2018_2123",2018,2018-07-15,195,2017-11-04,307,116,2018-04-27,174,2018-12-31,92.20608569,43.33667084,47.63999939,364,-248,79
"488","RED55_2018_2124",2018,2018-06-29,179,2017-09-19,261,115,2018-04-26,219,2018-03-26,27.88016306,10.87266202,11.67595816,84,31,64
"489","RED81_2018_2127",2018,2018-07-17,197,2017-10-10,282,108,2018-04-19,191,2018-07-04,37.03363122,15.35571012,16.41636703,184,-76,89
"490","RED57_2018_2130",2018,2018-06-21,171,2017-09-26,268,115,2018-04-26,212,2018-03-24,25.1005829,6.980315635,2.670000076,82,33,56
"491","NIP45_2018_2132",2018,2018-07-20,200,2017-10-09,281,117,2018-04-28,201,2018-05-02,76.289396,35.53140222,42.25999832,121,-4,83
"492","SLK162_2018_2133",2018,2018-09-07,249,2017-10-09,281,114,2018-04-25,198,2018-12-31,84.47945707,37.8793768,43.22777939,364,-250,135
"493","NOR61_2018_2134",2018,2018-07-10,190,2017-11-21,324,110,2018-04-21,151,2018-04-15,134.2086289,49.01549076,43.53000259,104,6,80
"494","SLK113_2018_2135",2018,2018-08-11,222,2017-09-02,244,131,2018-05-12,252,2018-12-31,72.1364005,23.48710975,22.17583275,364,-233,91
"495","NOR19_2018_2136",2018,2018-07-09,189,2017-11-09,312,124,2018-05-05,177,2018-04-15,145.1327026,54.37077904,49.29000092,104,20,65
"496","PEM6_2018_2137",2018,2018-07-21,201,2017-11-11,314,125,2018-05-06,176,2018-04-15,146.4215699,54.46423239,27.07625008,104,21,76
"497","RED78_2018_2138",2018,2018-07-18,198,2017-10-28,300,108,2018-04-19,173,2018-04-16,42.66383644,16.98708417,15.60000038,105,3,90
"498","COC15_2018_2139",2018,2018-07-18,198,2017-10-11,283,133,2018-05-14,215,2018-04-22,185.4772429,86.2033123,78.51000214,111,22,65
"499","NOR55_2018_2141",2018,2018-07-06,186,2017-11-18,321,124,2018-05-05,168,2018-04-15,143.5903227,54.40783375,46.15999985,104,20,62
"500","SLK26_2018_2142",2018,2018-06-26,176,2017-10-24,296,114,2018-04-25,183,2018-12-31,49.42209727,21.21800942,25.02144662,364,-250,62
"501","SLK55_2018_2143",2018,2018-07-08,188,2017-10-09,281,124,2018-05-05,208,2018-12-31,64.26396855,22.00374383,25.47999954,364,-240,64
"502","SLK22_2018_2144",2018,2018-06-21,171,2017-10-31,303,116,2018-04-27,178,2018-12-31,54.05667646,12.64017455,11.76000023,364,-248,55
"503","NIP20_2018_2146",2018,2018-06-27,177,2017-10-26,298,131,2018-05-12,198,2018-04-20,106.9285095,52.08734971,59.53548545,109,22,46
"504","RED76_2018_2147",2018,2018-07-19,199,2017-10-05,277,107,2018-04-18,195,2018-11-26,35.84730513,14.84379944,16.44582034,329,-222,92
"505","RED52_2018_2148",2018,2018-06-27,177,2017-10-21,293,115,2018-04-26,187,2018-03-24,21.12212769,6.39527996,6.75,82,33,62
"506","RED70_2018_2149",2018,2018-07-15,195,2017-10-15,287,112,2018-04-23,190,2018-11-27,55.02577625,24.74114266,24.35692825,330,-218,83
"507","NIP49_2018_2152",2018,2018-07-30,210,2017-09-30,272,121,2018-05-02,214,2018-05-02,78.21471346,36.59889901,43.18000031,121,0,89
"508","SLK27_2018_2154",2018,2018-06-26,176,2017-10-10,282,130,2018-05-11,213,2018-12-31,81.40222283,38.39004487,42.86233105,364,-234,46
"509","RED109_2018_2155",2018,2018-06-23,173,2017-10-09,281,111,2018-04-22,195,2018-04-05,44.17000131,17.45207646,15.60000038,94,17,62
"510","NIP16_2018_2157",2018,2018-06-28,178,2017-10-11,283,130,2018-05-11,212,2018-04-20,118.3418417,59.88522004,73.69999695,109,21,48
"511","RED121_2018_2158",2018,2018-07-18,198,2017-09-26,268,112,2018-04-23,209,2018-03-24,19.74813209,5.523617732,5.03000021,82,30,86
"512","COC36_2018_2159",2018,2018-08-07,218,2017-10-18,290,119,2018-04-30,194,2018-05-02,53.40789917,22.35808922,26.38999939,121,-2,99
"513","RED41_2012_1758",2012,2012-07-15,196,2011-10-04,276,127,2012-05-07,216,2012-03-11,160.2154709,63.17654908,30.38333321,70,57,69
"514","SLK85_2012_1760",2012,2012-07-19,200,2011-09-23,265,137,2012-05-17,237,2012-03-12,156.36018,62.64055513,26.58500099,71,66,63
"515","KLK8_2012_1841",2012,2012-05-22,142,2011-10-26,298,121,2012-05-01,188,2012-03-11,144.9076223,46.77524035,20.09500122,70,51,21
"516","RED49_2012_1844",2012,2012-07-08,189,2011-09-22,264,127,2012-05-07,228,2012-03-11,107.1651059,39.05510517,19.76666641,70,57,62
"517","RED28_2012_1849",2012,2012-06-06,157,2011-09-22,264,127,2012-05-07,228,2012-03-11,158.829391,63.67140145,35.30250168,70,57,30
"518","TIM9_2012_1852",2012,2012-05-21,141,2011-10-23,295,120,2012-04-30,190,2012-03-11,136.6143858,47.48864397,31.71771749,70,50,21
"519","KLK13_2012_1856",2012,2012-05-27,147,2011-10-26,298,121,2012-05-01,188,2012-03-11,130.0576261,38.68862629,7.380000114,70,51,26
"520","TIM7_2012_1898",2012,2012-05-16,136,2011-10-01,273,121,2012-05-01,213,2012-03-11,124.2983009,36.5500771,18.59250069,70,51,15
"521","RED39_2012_1901",2012,2012-07-13,194,2011-09-18,260,125,2012-05-05,230,2012-03-11,77.83465966,18.55098218,0.850000024,70,55,69
"522","TIM47_2012_1903",2012,2012-07-24,205,2011-10-01,273,121,2012-05-01,213,2012-03-11,133.3394567,37.53147766,16.44750023,70,51,84
"523","WAW5_2012_1904",2012,2012-05-14,134,2011-10-26,298,126,2012-05-06,193,2012-03-11,148.0846144,54.47798136,36.11999893,70,56,8
"524","KLK11_2012_1907",2012,2012-05-22,142,2011-11-21,324,121,2012-05-01,162,2012-03-11,125.3380287,37.32511697,8.161999702,70,51,21
"525","COC10_2012_1911",2012,2012-05-21,141,2011-10-29,301,126,2012-05-06,190,2012-03-12,172.332238,71.36242798,57.92599869,71,55,15
"526","WAW4_2012_1916",2012,2012-05-14,134,2011-12-01,334,121,2012-05-01,152,2012-03-11,187.1793762,74.76239477,55.32999802,70,51,13
"527","KEN36_2012_1917",2012,2012-05-18,138,2011-10-26,298,123,2012-05-03,190,2012-03-10,42.62497331,9.420220477,0,69,54,15
"528","TIM27_2012_1921",2012,2012-06-27,178,2011-11-11,314,123,2012-05-03,174,2012-03-11,143.0955958,51.43228988,41.0708313,70,53,55
"529","CHA8_2012_1924",2012,2012-05-15,135,2011-10-31,303,121,2012-05-01,183,2012-03-11,144.866543,53.40656883,43.52999878,70,51,14
"530","NIP32_2012_1929",2012,2012-07-12,193,2011-10-14,286,126,2012-05-06,205,2012-03-11,104.4785303,35.62524581,13.32499981,70,56,67
"531","PEM25_2012_1933",2012,2012-07-21,202,2011-10-29,301,107,2012-04-17,171,2012-03-06,124.698829,32.70604836,0.002777778,65,42,95
"532","WAW17_2012_1934",2012,2012-05-21,141,2011-11-15,318,126,2012-05-06,173,2012-03-22,168.2101383,67.17163772,53.86999893,81,45,15
"533","SLK20_2012_1919",2012,2012-06-06,157,2011-10-01,273,126,2012-05-06,218,2012-03-11,134.4021987,46.80129266,18.79000092,70,56,31
"534","HEA9_2012_1920",2012,2012-05-22,142,2011-09-16,258,125,2012-05-05,232,2012-03-11,144.2384802,53.50657555,40.61999893,70,55,17
"535","SLK105_2012_1931",2012,2012-08-07,219,2011-10-09,281,144,2012-05-24,228,2012-03-11,48.69201716,10.05776288,0,70,74,75
"536","RED103_2012_1757",2012,2012-08-01,213,2011-10-12,284,137,2012-05-17,218,2012-03-11,153.356674,58.76170748,33.52999878,70,67,76
"537","SLK73_2012_1759",2012,2012-08-01,213,2011-09-15,257,129,2012-05-09,237,2012-03-11,157.2005619,60.73056567,25.76166725,70,59,84
"538","NIP104_2012_1761",2012,2012-09-04,247,2011-09-23,265,126,2012-05-06,226,2012-03-11,102.6264588,32.57389569,12.81000042,70,56,121
"539","NIP59_2012_1762",2012,2012-07-14,195,2011-09-16,258,127,2012-05-07,234,2012-03-11,106.2194688,36.50868524,16.06999969,70,57,68
"540","NIP49_2012_1763",2012,2012-07-16,197,2011-10-29,301,137,2012-05-17,201,2012-03-12,174.5143759,77.21364134,71.07499695,71,66,60
"541","NIP63_2012_1764",2012,2012-07-13,194,2011-09-16,258,119,2012-04-29,226,2012-03-11,109.4700012,37.10980225,14.92750025,70,49,75
"542","SLK26_2012_1765",2012,2012-06-07,158,2011-10-20,292,129,2012-05-09,202,2012-03-11,167.0343375,67.17132235,28.38000107,70,59,29
"543","SLK72_2012_1766",2012,2012-07-19,200,2011-10-04,276,136,2012-05-16,225,2012-03-11,148.1797109,53.74323472,25.18499947,70,66,64
"544","NIP24_2012_1838",2012,2012-06-11,162,2011-10-22,294,126,2012-05-06,197,2012-03-11,95.04171233,31.63961219,12.20999908,70,56,36
"545","RED69_2012_1839",2012,2012-07-15,196,2011-09-20,262,127,2012-05-07,230,2012-03-11,147.6941509,56.29078566,32.07749939,70,57,69
"546","SLK101_2012_1840",2012,2012-07-30,211,2011-10-20,292,136,2012-05-16,209,2012-03-11,152.1734226,56.41224824,27.32166576,70,66,75
"547","RED53_2012_1842",2012,2012-07-15,196,2011-10-12,284,127,2012-05-07,208,2012-03-11,138.7174424,53.85525807,33.09749985,70,57,69
"548","RED61_2012_1843",2012,2012-07-18,199,2011-10-20,292,136,2012-05-16,209,2012-03-11,155.658421,63.92611667,37.48999786,70,66,63
"549","RED57_2012_1845",2012,2012-07-20,201,2011-10-20,292,127,2012-05-07,200,2012-03-11,143.7786881,55.04049629,30.83500099,70,57,74
"550","SLK91_2012_1846",2012,2012-07-29,210,2011-10-03,275,127,2012-05-07,217,2012-03-11,115.8853805,35.79422344,10.56374931,70,57,83
"551","NIP60_2012_1848",2012,2012-09-13,256,2011-10-20,292,126,2012-05-06,199,2012-03-11,103.2982055,35.5042806,15.89000034,70,56,130
"552","SLK32_2012_1850",2012,2012-06-09,160,2011-09-20,262,126,2012-05-06,229,2012-03-11,107.8699282,37.12439171,16.42000008,70,56,34
"553","SLK74_2012_1851",2012,2012-07-20,201,2011-10-16,288,129,2012-05-09,206,2012-03-11,158.3247422,60.95741341,25.46445549,70,59,72
"554","KEN103_2012_1853",2012,2012-09-08,251,2011-09-14,256,132,2012-05-12,241,2012-03-10,44.09411934,9.533279472,0,69,63,119
"555","RED94_2012_1854",2012,2012-07-28,209,2011-10-16,288,127,2012-05-07,204,2012-03-11,116.4480507,44.64295287,23.70499992,70,57,82
"556","SLK29_2012_1855",2012,2012-06-09,160,2011-09-15,257,127,2012-05-07,235,2012-03-11,163.5387006,66.30298728,33.42199707,70,57,33
"557","SLK82_2012_1857",2012,2012-07-22,203,2011-10-16,288,129,2012-05-09,206,2012-03-11,154.410658,59.2330905,23.20000076,70,59,74
"558","THU35_2012_1858",2012,2012-07-10,191,2011-10-23,295,127,2012-05-07,197,2012-03-11,107.7444139,29.16523887,0.664999962,70,57,64
"559","RED60_2012_1899",2012,2012-07-19,200,2011-10-20,292,136,2012-05-16,209,2012-03-11,165.3001383,69.25971001,44.58000183,70,66,64
"560","RED66_2012_1900",2012,2012-07-16,197,2011-10-20,292,127,2012-05-07,200,2012-03-11,149.362956,57.44626216,33.54000092,70,57,70
"561","RED52_2012_1902",2012,2012-07-15,196,2011-10-22,294,126,2012-05-06,197,2012-03-11,118.7450705,45.01284176,24.47999954,70,56,70
"562","RED64_2012_1905",2012,2012-07-19,200,2011-10-20,292,126,2012-05-06,199,2012-03-11,147.9290221,61.50155012,39.77000046,70,56,74
"563","RED72_2012_1906",2012,2012-07-19,200,2011-10-22,294,127,2012-05-07,198,2012-03-11,89.31106898,31.24563189,11.89439053,70,57,73
"564","RED51_2012_1908",2012,2012-07-15,196,2011-10-29,301,127,2012-05-07,191,2012-03-11,105.3148409,36.71043484,15.62714291,70,57,69
"565","RED59_2012_1909",2012,2012-07-09,190,2011-10-20,292,125,2012-05-05,198,2012-03-11,142.8412499,54.21034576,31.56000137,70,55,65
"566","SLK97_2012_1910",2012,2012-07-30,211,2011-10-20,292,129,2012-05-09,202,2012-03-11,136.2645339,48.29981845,20.72999954,70,59,82
"567","NIP62_2012_1912",2012,2012-07-22,203,2011-09-24,266,119,2012-04-29,218,2012-03-11,123.6641419,43.00384516,12.65499973,70,49,84
"568","RED38_2012_1913",2012,2012-07-13,194,2011-10-29,301,118,2012-04-28,182,2012-03-11,90.72692161,22.02028919,2.184615374,70,48,76
"569","SLK71_2012_1914",2012,2012-07-06,187,2011-10-20,292,136,2012-05-16,209,2012-03-11,141.1392686,50.05003742,22.03499985,70,66,51
"570","SLK81_2012_1915",2012,2012-07-17,198,2011-10-22,294,137,2012-05-17,208,2012-03-11,128.9488585,48.43278756,19.90999985,70,67,61
"571","RED71_2012_1918",2012,2012-07-13,194,2011-09-20,262,126,2012-05-06,229,2012-03-11,89.48922273,25.89715969,7.867712075,70,56,68
"572","RED58_2012_1922",2012,2012-07-19,200,2011-10-22,294,126,2012-05-06,197,2012-03-11,145.1048689,55.32740105,32.13000107,70,56,74
"573","RED63_2012_1923",2012,2012-07-16,197,2011-10-20,292,136,2012-05-16,209,2012-03-11,150.1592274,62.49489743,41.33666611,70,66,61
"574","RED34_2012_1925",2012,2012-07-04,185,2011-10-17,289,136,2012-05-16,212,2012-03-11,151.2852889,62.89464072,35.99900055,70,66,49
"575","RED50_2012_1926",2012,2012-07-16,197,2011-10-22,294,127,2012-05-07,198,2012-03-11,102.6829005,35.88065965,15.67324207,70,57,70
"576","SLK79_2012_1927",2012,2012-07-16,197,2011-10-23,295,136,2012-05-16,206,2012-03-12,160.5264533,69.24306724,47.15999985,71,65,61
"577","SLK93_2012_1928",2012,2012-07-25,206,2011-10-15,287,126,2012-05-06,204,2012-03-11,104.6489022,34.24027313,10.78000069,70,56,80
"578","NIP61_2012_1930",2012,2012-07-23,204,2011-10-15,287,126,2012-05-06,204,2012-03-11,103.5979088,35.16376615,15.40499973,70,56,78
"579","SLK47_2012_1932",2012,2012-07-14,195,2011-10-01,273,126,2012-05-06,218,2012-03-11,110.5524243,30.2748598,4.423333168,70,56,69
"580","FOR59_2012_1935",2012,2012-09-05,248,2011-10-23,295,119,2012-04-29,189,2012-03-10,40.99009103,7.722547178,0,69,50,129
"581","RED62_2012_1936",2012,2012-07-19,200,2011-09-22,264,136,2012-05-16,237,2012-03-11,149.2200467,62.46808581,39.10416412,70,66,64
"582","RED70_2012_1937",2012,2012-07-14,195,2011-10-23,295,126,2012-05-06,196,2012-03-11,155.1520798,60.68201535,36.9291687,70,56,69
"583","SLK51_2003_1403",2003,2003-06-22,172,2002-10-30,302,135,2003-05-16,198,2003-04-07,97.4639277,40.06867826,41.92874908,96,39,37
"584","SLK70_2003_1431",2003,2003-06-23,173,2002-10-21,293,138,2003-05-19,210,2003-12-31,100.2075808,43.27823319,49.625,364,-226,35
"585","NIP81_2003_1437",2003,2003-08-16,227,2002-09-28,270,150,2003-05-31,245,2003-04-08,68.38311534,35.88619124,44.68000031,97,53,77
"586","RED93_2003_1545",2003,2003-08-19,230,2002-10-23,295,142,2003-05-23,212,2003-04-07,83.78965414,33.53957635,36.79000092,96,46,88
"587","SLK80_2003_1547",2003,2003-07-18,198,2002-10-09,281,136,2003-05-17,220,2003-04-07,111.7074632,46.84294694,48.38999939,96,40,62
"588","RED4_2014_2019",2014,2014-06-05,155,2013-10-08,280,105,2014-04-16,190,2014-04-05,92.4493626,34.24180389,28.81999969,94,11,50
"589","SLK13_2014_1881",2014,2014-08-09,220,2013-09-21,263,121,2014-05-02,223,2014-04-19,84.62598256,31.44571642,29.04000092,108,13,99
"590","RED8_2014_1882",2014,2014-06-06,156,2013-10-08,280,120,2014-05-01,205,2014-08-09,57.02482556,21.32393532,18.26000023,220,-100,36
"591","RED29_2014_2017",2014,2014-08-19,230,2013-10-27,299,114,2014-04-25,180,2014-04-18,126.7486194,49.16506589,48.77000046,107,7,116
"592","RED17_2014_2020",2014,2014-07-13,193,2013-10-08,280,101,2014-04-12,186,2014-04-18,97.88134231,32.05709698,27.02000046,107,-6,92
"593","RED124_2011_1958",2011,2011-08-01,212,2010-10-10,282,78,2011-03-20,161,2011-03-20,111.9449422,38.50418294,38.28311374,78,0,134
"594","NIP92_2003_1402",2003,2003-08-17,228,2002-10-12,284,142,2003-05-23,223,2003-04-08,69.12718903,36.14320555,45.84000015,97,45,86
"595","NIP68_2003_1407",2003,2003-07-16,196,2002-09-02,244,143,2003-05-24,264,2003-12-31,67.03516311,29.67034873,36.52999878,364,-221,53
"596","RED90_2003_1422",2003,2003-08-17,228,2002-10-29,301,139,2003-05-20,203,2003-04-07,89.16241338,35.55968051,38.05124664,96,43,89
"597","RED91_2003_1438",2003,2003-08-18,229,2002-10-27,299,148,2003-05-29,214,2003-04-07,83.58680539,34.0241996,37.81999969,96,52,81
"598","SLK101_2003_1480",2003,2003-08-21,232,2002-09-26,268,140,2003-05-21,237,2003-12-31,92.34007727,35.1017354,39.43999863,364,-224,92
"599","NIP72_2003_1483",2003,2003-07-17,197,2002-10-18,290,140,2003-05-21,215,2003-12-31,71.30390767,30.51748844,38.31200027,364,-224,57
"600","SLK94_2003_1494",2003,2003-08-18,229,2002-10-09,281,143,2003-05-24,227,2003-12-31,93.11105695,37.98915975,42.29888916,364,-221,86
"601","RED82_2003_1498",2003,2003-07-22,202,2002-10-28,300,136,2003-05-17,201,2003-04-07,93.87016767,38.37395441,41.24625015,96,40,66
"602","NIP95_2003_1500",2003,2003-08-18,229,2002-10-15,287,142,2003-05-23,220,2003-12-31,72.03701759,29.09270079,36.47333145,364,-222,87
"603","SLK71_2003_1538",2003,2003-07-23,203,2002-10-03,275,140,2003-05-21,230,2003-12-18,90.47902391,40.2933357,45.93999863,351,-211,63
"604","NIP59_2003_1555",2003,2003-06-23,173,2002-11-07,310,138,2003-05-19,193,2003-04-08,94.438418,39.25559362,31.84000015,97,41,35
"605","NIP79_2003_1558",2003,2003-08-17,228,2002-10-17,289,136,2003-05-17,212,2003-04-08,70.00861788,31.4518114,31.39799881,97,39,92
"606","DRY5_2003_1418",2003,2003-04-10,99,2002-10-18,290,108,2003-04-19,183,2003-03-14,46.15999985,12.5635643,4.139999866,72,36,-9
"607","FOR11_2003_1420",2003,2003-05-01,120,2002-12-20,353,97,2003-04-08,109,2003-03-14,40.01970176,11.02174009,9.109999657,72,25,23
"608","NIP42_2003_1430",2003,2003-06-17,167,2002-10-29,301,139,2003-05-20,203,2003-04-08,87.11625234,40.20344229,41.06000137,97,42,28
"609","SLK66_2003_1432",2003,2003-06-23,173,2002-10-20,292,140,2003-05-21,213,2003-12-31,87.30877346,35.5028697,41.81999969,364,-224,33
"610","FOR14_2003_1484",2003,2003-05-04,123,2002-12-01,334,97,2003-04-08,128,2003-03-14,58.99687739,16.98466487,13.10999966,72,25,26
"611","SLK65_2003_1488",2003,2003-06-19,169,2002-09-28,270,142,2003-05-23,237,2003-12-31,86.53254582,34.8857535,41.25999832,364,-222,27
"612","RED32_2010_1751",2010,2010-05-27,146,2009-10-12,284,116,2010-04-27,197,2010-03-05,93.99898493,30.83840984,2.587499857,63,53,30
"613","RED44_2010_1753",2010,2010-08-24,235,2009-11-07,310,114,2010-04-25,169,2010-03-02,93.16670381,30.21578692,2.440000057,60,54,121
"614","RED26_2010_1755",2010,2010-05-20,139,2009-10-14,286,119,2010-04-30,198,2010-03-04,97.1088939,30.32035382,0,62,57,20
"615","RED25_2010_1756",2010,2010-05-19,138,2009-09-06,248,101,2010-04-12,218,2010-03-05,83.64269171,24.61321271,0,63,38,37
"616","NIP35_2010_1767",2010,2010-06-19,169,2009-10-12,284,119,2010-04-30,200,2010-03-06,65.97677217,20.206837,0,64,55,50
"617","HEA31_2010_1768",2010,2010-06-27,177,2009-11-07,310,123,2010-05-04,178,2010-03-30,145.8915587,51.41094825,22.34749985,88,35,54
"618","HEA20_2010_1770",2010,2010-05-25,144,2009-11-26,329,120,2010-05-01,156,2010-03-06,103.9284223,34.46035434,19.19000053,64,56,24
"619","FOR3_2010_1771",2010,2010-03-29,87,2009-11-07,310,101,2010-04-12,156,2010-03-05,47.58897279,12.37816612,0,63,38,-14
"620","KLK5_2010_1772",2010,2010-05-14,133,2009-11-06,309,104,2010-04-15,160,2010-03-06,83.44233942,25.31000731,5.775000095,64,40,29
"621","TIM9_2010_1773",2010,2010-05-20,139,2009-10-18,290,104,2010-04-15,179,2010-03-06,87.59378655,26.91908089,6.28000021,64,40,35
"622","TIM7_2010_1774",2010,2010-05-20,139,2009-12-06,339,103,2010-04-14,129,2010-03-06,75.77219912,22.34871637,5.090000153,64,39,36
"623","WAW18_2010_1775",2010,2010-05-28,147,2009-10-23,295,112,2010-04-23,182,2010-12-11,89.63722188,30.71039554,1.100000024,344,-232,35
"624","TIM13_2010_1776",2010,2010-05-27,146,2009-09-13,255,102,2010-04-13,212,2010-03-06,65.96797747,18.02024655,0,64,38,44
"625","SLK49_2010_1730",2010,2010-06-26,176,2009-10-10,282,117,2010-04-28,200,2010-03-04,65.59130131,21.09360027,3.279999971,62,55,59
"626","SLK63_2010_1729",2010,2010-07-19,199,2009-09-29,271,133,2010-05-14,227,2010-03-28,74.68978819,26.29450495,11.48999977,86,47,66
"627","NIP41_2010_1731",2010,2010-06-26,176,2009-10-12,284,119,2010-04-30,200,2010-03-06,59.19062685,18.97488886,2.730000019,64,55,57
"628","SLK65_2010_1732",2010,2010-07-25,205,2009-10-07,279,133,2010-05-14,219,2010-03-01,76.58052428,26.88553492,11.87749958,59,74,72
"629","SLK64_2010_1733",2010,2010-07-19,199,2009-10-16,288,117,2010-04-28,194,2010-03-01,75.99708295,26.6097813,11.51000023,59,58,82
"630","NIP27_2010_1734",2010,2010-05-17,136,2009-10-20,292,119,2010-04-30,192,2010-03-29,59.51109977,18.75241422,0.899999976,87,32,17
"631","NIP45_2010_1752",2010,2010-06-21,171,2009-10-10,282,119,2010-04-30,202,2010-03-06,52.29411237,15.88512527,0,64,55,52
"632","RED7_2008_1665",2008,2008-06-21,172,2007-09-27,269,123,2008-05-03,219,2008-04-13,116.229857,45.55117997,36.87000275,103,20,49
"633","SLK34_2008_1666",2008,2008-09-01,244,2007-09-16,258,124,2008-05-04,231,2008-05-02,92.6593841,34.18684108,32.14500046,122,2,120
"634","SLK29_2008_1667",2008,2008-08-18,230,2007-10-12,284,128,2008-05-08,209,2008-05-03,94.37777062,31.12000919,26.35250092,123,5,102
"635","THU38_2008_1668",2008,2008-08-22,234,2007-10-25,297,124,2008-05-04,192,2008-04-06,89.65713438,38.03965376,37.00999832,96,28,110
"636","SLK97_2006_1591",2006,2006-08-31,242,2005-10-26,298,68,2006-03-10,135,2006-12-31,100.7685996,40.14007659,33.97000122,364,-296,174
"637","NIP151_2006_1592",2006,2006-08-07,218,2005-10-09,281,105,2006-04-16,189,2006-12-31,90.62263778,30.81925455,26.38999939,364,-259,113
"638","SLK44_2006_1593",2006,2006-07-15,195,2005-10-22,294,122,2006-05-03,193,2006-03-29,90.07083004,37.22028771,35.97999954,87,35,73
"639","RED14_2006_1594",2006,2006-06-15,165,2005-10-16,288,108,2006-04-19,185,2006-03-27,78.17615677,30.97538077,20.02000046,85,23,57
"640","RED15_2006_1595",2006,2006-06-18,168,2005-09-23,265,109,2006-04-20,209,2006-03-27,108.8916054,44.15380662,30.37750053,85,24,59
"641","NIP327_2006_1596",2006,2006-09-15,257,2005-11-18,321,85,2006-03-27,129,2006-12-31,49.51290104,14.67365459,3.289999962,364,-279,172
"642","THU187_2006_1598",2006,2006-09-10,252,2005-10-24,296,85,2006-03-27,154,2006-03-07,109.1945104,42.57979045,31.63454628,65,20,167
"643","SLK118_2006_1590",2006,2006-09-10,252,2005-09-29,271,122,2006-05-03,216,2006-03-27,87.53280542,35.61643505,33.84666824,85,37,130
"644","THU246_2006_1597",2006,2006-09-14,256,2005-11-18,321,85,2006-03-27,129,2006-03-07,82.18385381,32.99228538,31.92000008,65,20,171
"645","SLK1_2003_1453",2003,2003-06-18,168,2002-10-22,294,144,2003-05-25,215,2003-12-31,82.89428836,31.63344935,36.13999939,364,-220,24
"646","SLK4_2003_1401",2003,2003-07-06,186,2002-10-21,293,141,2003-05-22,213,2003-11-13,91.47225405,40.0678676,45.36500168,316,-175,45
"647","RED27_2011_1701",2011,2011-07-05,185,2010-09-05,247,79,2011-03-21,197,2011-04-13,116.6594379,46.65655833,49.83000183,102,-23,106
"648","RED93_2011_1738",2011,2011-07-08,188,2010-09-08,250,79,2011-03-21,194,2011-03-31,120.1592149,44.20473696,46.40999985,89,-10,109
"649","SLK132_2011_1740",2011,2011-08-08,219,2010-09-23,265,97,2011-04-08,197,2011-04-19,109.43344,41.76467415,46.58000183,108,-11,122
"650","RED111_2011_1742",2011,2011-07-21,201,2010-10-17,289,79,2011-03-21,155,2011-03-31,123.2746083,45.52769807,47.91333389,89,-10,122
"651","RED113_2011_1743",2011,2011-07-21,201,2010-10-03,275,79,2011-03-21,169,2011-03-31,121.3059812,44.69739264,46.99000168,89,-10,122
"652","KEN91_2011_1748",2011,2011-08-12,223,2010-10-03,275,80,2011-03-22,170,2011-12-31,65.8330977,17.24646466,7.137500286,364,-284,143
"653","WAW12_2011_1749",2011,2011-06-08,158,2010-10-29,301,78,2011-03-20,142,2011-04-02,128.4187612,46.14848431,41.42000198,91,-13,80
"654","TIM34_2011_1750",2011,2011-09-26,268,2010-10-20,292,78,2011-03-20,151,2011-03-20,109.9777149,41.69437881,32.97000122,78,0,190
"655","SLK40_2011_1693",2011,2011-06-19,169,2010-10-23,295,111,2011-04-22,181,2011-04-20,81.20753663,34.49883062,39.38999939,109,2,58
"656","SLK46_2011_1694",2011,2011-06-18,168,2010-10-16,288,110,2011-04-21,187,2011-04-20,77.38194968,32.97626096,39.24499893,109,1,58
"657","SLK45_2011_1695",2011,2011-07-01,181,2010-09-23,265,110,2011-04-21,210,2011-04-20,71.69389661,28.99858838,31.57999992,109,1,71
"658","NIP34_2011_1696",2011,2011-07-02,182,2010-09-24,266,113,2011-04-24,212,2011-04-20,87.97246625,33.85357227,31.15999985,109,4,69
"659","SLK79_2011_1697",2011,2011-07-17,197,2010-09-28,270,103,2011-04-14,198,2011-04-20,82.43637892,33.03437171,37.36999893,109,-6,94
"660","NIP47_2011_1698",2011,2011-07-17,197,2010-09-18,260,98,2011-04-09,203,2011-04-20,111.7973666,42.96655167,39.93000031,109,-11,99
"661","SLK75_2011_1699",2011,2011-07-16,196,2010-10-17,289,97,2011-04-08,173,2011-04-20,92.81113925,36.23137911,43.40076945,109,-12,99
"662","SLK147_2011_1700",2011,2011-09-11,253,2010-09-16,258,79,2011-03-21,186,2011-04-19,98.33871317,37.18882548,42.68777847,108,-29,174
"663","RED91_2011_1702",2011,2011-07-04,184,2010-10-01,273,79,2011-03-21,171,2011-04-19,125.2830499,47.82369251,48,108,-29,105
"664","RED35_2011_1721",2011,2011-07-04,184,2010-10-30,302,92,2011-04-03,155,2011-04-19,132.9454563,50.10087123,48.81000137,108,-16,92
"665","RED121_2011_1722",2011,2011-07-05,185,2010-10-22,294,79,2011-03-21,150,2011-04-19,123.0778812,45.06500993,44.79000092,108,-29,106
"666","RED66_2011_1723",2011,2011-07-06,186,2010-10-02,274,79,2011-03-21,170,2011-03-31,92.65399237,33.01826934,32.65000153,89,-10,107
"667","RED67_2011_1724",2011,2011-07-06,186,2010-10-16,288,79,2011-03-21,156,2011-03-31,95.05968916,34.0561182,34.47999954,89,-10,107
"668","NIP54_2011_1735",2011,2011-07-21,201,2010-10-14,286,81,2011-03-23,160,2011-04-20,118.5685249,44.21773405,45.6772728,109,-28,120
"669","SLK103_2011_1736",2011,2011-07-21,201,2010-09-18,260,79,2011-03-21,184,2011-04-20,112.4333034,42.63164987,44.68000031,109,-30,122
"670","SLK101_2011_1737",2011,2011-07-19,199,2010-09-23,265,81,2011-03-23,181,2011-04-19,106.5627713,41.11265232,47.31000137,108,-27,118
"671","SLK57_2011_1739",2011,2011-07-01,181,2010-10-18,290,79,2011-03-21,154,2011-04-19,101.8458526,39.36220159,45.68999863,108,-29,102
"672","SLK55_2011_1741",2011,2011-07-07,187,2010-09-20,262,80,2011-03-22,183,2011-04-19,101.5764764,39.03648485,44.54000092,108,-28,107
"673","RED112_2011_1744",2011,2011-07-18,198,2010-10-17,289,79,2011-03-21,155,2011-03-31,123.5299988,46.20970154,47.84000015,89,-10,119
"674","SLK71_2011_1745",2011,2011-07-06,186,2010-09-21,263,79,2011-03-21,181,2011-04-20,108.3097845,41.05310969,43.81999969,109,-30,107
"675","THU57_2011_1746",2011,2011-08-01,212,2010-10-24,296,82,2011-03-24,151,2011-04-19,96.66915284,36.33537825,41.09000015,108,-26,130
"676","NIP94_2011_1747",2011,2011-08-08,219,2010-09-28,270,82,2011-03-24,177,2011-03-28,75.44702747,30.42922754,28.84272766,86,-4,137
"677","THU21_2009_1719",2009,2009-06-18,168,2008-09-07,250,89,2009-03-31,204,2009-03-31,98.44415492,32.23815639,29.73999977,89,0,79
"678","COC16_2009_1720",2009,2009-06-26,176,2008-09-29,272,94,2009-04-05,187,2009-04-15,181.659116,74.35776298,67.09999847,104,-10,82
"679","SLK22_2009_1704",2009,2009-06-22,172,2008-09-04,247,102,2009-04-13,220,2009-04-11,95.73862963,37.81511988,36.81000137,100,2,70
"680","SLK17_2009_1705",2009,2009-06-18,168,2008-09-06,249,102,2009-04-13,218,2009-05-19,101.3053002,39.65127976,38.04000092,138,-36,66
"681","SLK10_2009_1706",2009,2009-06-17,167,2008-10-03,276,102,2009-04-13,191,2009-05-10,92.20869213,30.59139948,22.39999962,129,-27,65
"682","SLK13_2009_1707",2009,2009-06-18,168,2008-09-05,248,103,2009-04-14,220,2009-04-11,82.35266748,27.24167881,18.89999962,100,3,65
"683","NIP23_2009_1708",2009,2009-06-17,167,2008-11-12,316,108,2009-04-19,157,2009-04-12,82.67784019,27.94220115,18.81999969,101,7,59
"684","NIP21_2009_1709",2009,2009-06-17,167,2008-10-02,275,109,2009-04-20,199,2009-05-19,90.37052382,30.98732205,18.14153862,138,-29,58
"685","NIP20_2009_1710",2009,2009-06-17,167,2008-09-28,271,94,2009-04-05,188,2009-05-19,83.7669432,27.41971387,16.47999954,138,-44,73
"686","NIP19_2009_1711",2009,2009-06-17,167,2008-10-25,298,94,2009-04-05,161,2009-05-19,91.98682658,28.62295072,16.53000069,138,-44,73
"687","SLK23_2009_1712",2009,2009-06-25,175,2008-09-25,268,73,2009-03-15,170,2009-04-11,91.59224096,32.23559728,28.30999947,100,-27,102
"688","NIP13_2009_1713",2009,2009-06-19,169,2008-09-20,263,101,2009-04-12,203,2009-04-12,54.32342428,18.93949127,15.26666641,101,0,68
"689","NIP14_2009_1714",2009,2009-06-19,169,2008-09-04,247,95,2009-04-06,213,2009-04-19,56.95698761,19.90451328,15.18999958,108,-13,74
"690","SLK26_2009_1715",2009,2009-06-24,174,2008-09-10,253,101,2009-04-12,213,2009-04-11,99.45991808,35.10397613,30.07999992,100,1,73
"691","RED10_2009_1716",2009,2009-06-21,171,2008-09-25,268,90,2009-04-01,187,2009-04-11,89.50721577,28.42309952,21.05666733,100,-10,81
"692","NIP10_2009_1717",2009,2009-06-19,169,2008-09-25,268,94,2009-04-05,191,2009-04-12,46.10442154,15.34147158,14.71500015,101,-7,75
"693","NIP12_2009_1718",2009,2009-06-17,167,2008-09-08,251,90,2009-04-01,204,2009-03-31,35.58222603,10.9507721,6.975714207,89,1,77
"694","COC37_2005_1533",2005,2005-07-17,197,2004-11-10,314,110,2005-04-21,161,2005-03-29,151.8272659,62.38389528,61.61499786,87,23,87
"695","COC14_2009_1703",2009,2009-06-24,174,2008-10-06,279,96,2009-04-07,182,2009-04-15,134.6377033,51.87474406,46.3971405,104,-8,78
"696","CHA10_2010_1589",2010,2010-05-13,132,2009-09-24,266,102,2010-04-13,201,2010-03-06,85.43000031,28.07052803,4.21999979,64,38,30
"697","NIP73_2001_41",2001,2001-07-21,201,2000-11-13,317,133,2001-05-14,181,2001-04-18,90.93869559,35.36579588,18.82500076,107,26,68
"698","SLK45_2001_44",2001,2001-07-20,200,2000-09-15,258,133,2001-05-14,240,2001-04-18,115.4068483,43.50387525,20.61000061,107,26,67
"699","NIP72_2001_68",2001,2001-07-21,201,2000-09-30,273,134,2001-05-15,226,2001-03-30,90.56143701,35.72153875,15.14466667,88,46,67
"700","NIP74_2001_70",2001,2001-07-21,201,2000-10-26,299,140,2001-05-21,206,2001-04-18,91.01844927,35.66697062,18.87533379,107,33,61
"701","NIP53_2001_1",2001,2001-06-10,160,2000-10-17,290,154,2001-06-04,229,2001-04-18,91.50649744,33.3876136,19.56999969,107,47,6
"702","NIP39_2001_2",2001,2001-06-10,160,2000-10-29,302,132,2001-05-13,195,2001-04-18,95.43261684,36.82151345,18.58571434,107,25,28
"703","NIP35_2001_5",2001,2001-06-10,160,2000-10-21,294,126,2001-05-07,197,2001-04-22,104.2682888,37.73091528,20.40999985,111,15,34
"704","NIP24_2001_7",2001,2001-06-10,160,2000-11-27,331,126,2001-05-07,160,2001-04-22,144.3314154,52.75954933,30.43000031,111,15,34
"705","KLK2_2001_10",2001,2001-04-30,119,2000-11-23,327,112,2001-04-23,150,2001-03-13,119.8327699,39.20580696,24.30500031,71,41,7
"706","PEM3_2001_11",2001,2001-04-26,115,2000-12-13,347,75,2001-03-17,93,2001-03-13,142.9522176,42.06283293,10.91500092,71,4,40
"707","SLK3_2001_39",2001,2001-07-16,196,2000-09-30,273,147,2001-05-28,239,2001-03-29,104.3745405,39.30755915,13.19999981,87,60,49
"708","NIP26_2001_47",2001,2001-06-10,160,2000-11-19,323,126,2001-05-07,168,2001-04-22,122.9330824,44.6244675,29.56999969,111,15,34
"709","COC15_2001_48",2001,2001-06-10,160,2000-11-18,322,121,2001-05-02,164,2001-04-22,204.5484846,78.16887579,56.86000061,111,10,39
"710","PET1_2001_50",2001,2001-07-28,208,2000-11-08,312,73,2001-03-15,126,2001-03-13,179.8999939,56.81152344,28.16500092,71,2,135
"711","SLK44_2001_67",2001,2001-07-21,201,2000-11-19,323,149,2001-05-30,191,2001-03-29,98.95506714,37.43020138,14.80866718,87,62,52
"712","SLK47_2001_69",2001,2001-07-21,201,2000-10-24,297,141,2001-05-22,209,2001-03-29,108.5658654,41.18818709,14.18599987,87,54,60
"713","RED39_2002_90",2002,2002-07-15,195,2001-11-23,326,113,2002-04-24,152,2002-04-28,161.1689218,67.4119352,74.53799438,117,-4,82
"714","RED23_2002_168",2002,2002-07-16,196,2001-11-13,316,111,2002-04-22,160,2002-04-10,128.284985,55.1910804,62.61249924,99,12,85
"715","RED21_2002_170",2002,2002-07-17,197,2001-10-20,292,112,2002-04-23,185,2002-04-10,144.0398206,61.06560314,68.53666687,99,13,85
"716","RED66_2002_181",2002,2002-07-17,197,2001-10-24,296,121,2002-05-02,190,2002-04-28,179.0164379,75.7997685,86.15000153,117,4,76
"717","RED5_2002_185",2002,2002-07-09,189,2001-10-30,302,117,2002-04-28,180,2002-04-28,160.3870034,69.94673865,79.397995,117,0,72
"718","RED27_2002_191",2002,2002-07-17,197,2001-11-13,316,112,2002-04-23,161,2002-04-12,125.9379835,54.24892555,61.15000153,101,11,85
"719","NIP16_2002_77",2002,2002-06-03,153,2001-12-04,337,100,2002-04-11,128,2002-04-06,82.59876204,17.82815679,1.373333335,95,5,53
"720","DRY10_2002_75",2002,2002-06-01,151,2001-10-10,282,99,2002-04-10,182,2002-04-06,72.90837614,22.23333669,19.47908974,95,4,52
"721","RED47_2002_92",2002,2002-07-17,197,2001-10-20,292,110,2002-04-21,183,2002-04-10,118.3520968,42.08058896,36.06999969,99,11,87
"722","THU16_2002_102",2002,2002-05-24,143,2001-10-30,302,100,2002-04-11,163,2002-04-06,170.5987746,67.59469679,78.04333496,95,5,43
"723","RED60_2002_175",2002,2002-07-16,196,2001-10-30,302,112,2002-04-23,175,2002-04-11,129.1672961,48.36996738,51.06999969,100,12,84
"724","NIP52_2001_3",2001,2001-06-09,159,2000-09-15,258,148,2001-05-29,255,2001-04-27,93.65931113,34.2807674,19.52714348,116,32,11
"725","NIP54_2001_40",2001,2001-06-09,159,2000-10-08,281,172,2001-06-22,256,2001-04-18,90.45170506,35.40500777,16.15999985,107,65,-13
"726","RED60_2001_42",2001,2001-07-21,201,2000-10-04,277,131,2001-05-12,219,2001-04-18,138.7455944,52.10008422,18.72400093,107,24,70
"727","SLK24_2001_43",2001,2001-06-10,160,2000-11-19,323,140,2001-05-21,182,2001-04-18,107.8676193,41.811056,20.26428604,107,33,20
"728","NIP22_2001_46",2001,2001-06-10,160,2000-10-23,296,141,2001-05-22,210,2001-04-22,121.748776,41.9070695,26.86999893,111,30,19
"729","RED61_2001_65",2001,2001-07-18,198,2000-10-21,294,138,2001-05-19,209,2001-04-18,125.9533061,48.22582844,14.30000019,107,31,60
"730","NIP55_2001_66",2001,2001-06-09,159,2000-10-26,299,140,2001-05-21,206,2001-04-18,90.37253956,35.43984514,18.87533379,107,33,19
"731","RED48_2001_72",2001,2001-06-21,171,2000-10-23,296,152,2001-06-02,221,2001-04-18,102.187653,39.44810704,22.13000107,107,45,19
"732","NIP77_2001_49",2001,2001-07-24,204,2000-11-21,325,112,2001-04-23,152,2001-04-22,125.8844056,44.95254048,34.13800049,111,1,92
"733","SLK5_2002_12",2002,2002-07-06,186,2001-10-30,302,128,2002-05-09,191,2002-04-28,137.0832993,60.34337746,80.38600159,117,11,58
"734","SLK6_2002_13",2002,2002-07-18,198,2001-10-30,302,128,2002-05-09,191,2002-04-28,162.6329569,69.69277179,88.22000122,117,11,70
"735","SLK7_2002_14",2002,2002-07-16,196,2001-11-07,310,128,2002-05-09,183,2002-04-28,147.3154964,65.13262149,86.25666809,117,11,68
"736","SLK1_2002_16",2002,2002-07-11,191,2001-10-23,295,125,2002-05-06,195,2002-04-28,168.5593168,73.5111231,93.20999908,117,8,66
"737","SLK8_2002_18",2002,2002-07-21,201,2001-10-30,302,127,2002-05-08,190,2002-04-28,151.9466131,67.00104741,87.80999756,117,10,74
"738","SLK2_2002_51",2002,2002-06-28,178,2001-10-06,278,124,2002-05-05,211,2002-04-28,166.7028971,72.64810809,90.40999603,117,7,54
"739","SLK3_2002_52",2002,2002-06-28,178,2001-10-30,302,124,2002-05-05,187,2002-04-28,167.755374,73.30143239,91.44000244,117,7,54
"740","SLK36_2002_56",2002,2002-07-07,187,2001-10-13,285,129,2002-05-10,209,2002-04-28,152.2323986,67.76554413,87.33599854,117,12,58
"741","NIP83_2002_88",2002,2002-07-18,198,2001-10-28,300,128,2002-05-09,193,2002-05-11,119.2121179,54.62515556,64.48000336,130,-2,70
"742","RED40_2002_91",2002,2002-07-17,197,2001-11-21,324,115,2002-04-26,156,2002-04-28,164.4617316,72.59028642,80.69999695,117,-2,82
"743","NIP38_2002_97",2002,2002-07-05,185,2001-10-30,302,120,2002-05-01,183,2002-04-11,117.9820801,44.39975077,35.79000092,100,20,65
"744","NIP55_2002_164",2002,2002-07-13,193,2001-10-30,302,128,2002-05-09,191,2002-05-11,127.2108576,58.06635255,68.27999878,130,-2,65
"745","SLK70_2002_166",2002,2002-07-18,198,2001-10-30,302,124,2002-05-05,187,2002-05-11,177.5074711,80.18521843,102.1166687,130,-6,74
"746","RED56_2002_167",2002,2002-07-16,196,2001-11-23,326,111,2002-04-22,150,2002-04-28,137.7471307,60.12675225,65.53500366,117,-6,85
"747","RED41_2002_169",2002,2002-07-15,195,2001-10-03,275,111,2002-04-22,201,2002-04-10,126.9870557,54.18027456,57.84999847,99,12,84
"748","RED63_2002_171",2002,2002-07-17,197,2001-10-30,302,115,2002-04-26,178,2002-04-10,138.6503612,56.07566372,62.41909027,99,16,82
"749","SLK19_2002_172",2002,2002-07-05,185,2001-10-03,275,114,2002-04-25,204,2002-05-10,193.2606791,85.17681859,96.34999847,129,-15,71
"750","NIP56_2002_174",2002,2002-07-12,192,2001-10-30,302,121,2002-05-02,184,2002-04-11,105.1755028,46.65328293,46.74000168,100,21,71
"751","NIP101_2002_176",2002,2002-07-19,199,2001-10-09,281,133,2002-05-14,217,2002-04-28,137.1260192,60.43687061,78.68000031,117,16,66
"752","SLK21_2002_177",2002,2002-06-29,179,2001-10-30,302,128,2002-05-09,191,2002-04-28,165.8042144,72.92817749,92.73000336,117,11,51
"753","SLK68_2002_178",2002,2002-07-16,196,2001-10-30,302,124,2002-05-05,187,2002-04-28,180.2675512,77.23424012,91.84999847,117,7,72
"754","SLK54_2002_179",2002,2002-07-17,197,2001-11-05,308,124,2002-05-05,181,2002-04-28,192.282057,84.52403338,103.6733322,117,7,73
"755","NIP48_2002_180",2002,2002-07-06,186,2001-10-13,285,128,2002-05-09,208,2002-04-28,150.8197669,67.16929907,87.50500488,117,11,58
"756","NIP47_2002_182",2002,2002-07-05,185,2001-10-30,302,128,2002-05-09,191,2002-04-28,151.3961531,67.29709385,87.67199707,117,11,57
"757","RED38_2002_186",2002,2002-07-15,195,2001-09-13,255,110,2002-04-21,220,2002-04-28,148.8516062,61.86674711,68.63749695,117,-7,85
"758","NIP79_2002_189",2002,2002-07-17,197,2001-10-30,302,128,2002-05-09,191,2002-04-11,101.6329661,48.65837697,58.11800003,100,28,69
"759","RED34_2002_190",2002,2002-07-15,195,2001-11-13,316,111,2002-04-22,160,2002-04-18,133.0731564,57.67183838,63.61999893,107,4,84
"760","SLK11_2002_54",2002,2002-06-19,169,2001-10-30,302,126,2002-05-07,189,2002-04-28,164.6422869,72.55129654,92.55999756,117,9,43
"761","SLK12_2002_55",2002,2002-06-19,169,2001-10-30,302,132,2002-05-13,195,2002-04-28,166.2280401,72.60106475,92.19999695,117,15,37
"762","RED55_2002_95",2002,2002-07-18,198,2001-11-10,313,104,2002-04-15,156,2002-04-10,103.5901267,34.90666846,32.90999985,99,5,94
"763","NIP81_2002_96",2002,2002-07-18,198,2001-10-30,302,120,2002-05-01,183,2002-04-06,153.4171385,65.17180344,71.45500183,95,25,78
"764","COC9_2002_100",2002,2002-07-02,182,2001-10-09,281,125,2002-05-06,209,2002-04-11,242.8885687,104.4843309,109.5199966,100,25,57
"765","PEM9_2002_104",2002,2002-08-11,222,2001-12-23,356,90,2002-04-01,99,2002-03-26,72.05100182,16.44839424,0,84,6,132
"766","NIP54_2002_173",2002,2002-07-09,189,2001-10-30,302,122,2002-05-03,185,2002-04-12,138.3900035,61.84379344,71.61000061,101,21,67
"767","SLK17_2002_193",2002,2002-07-01,181,2001-10-30,302,116,2002-04-27,179,2002-04-11,155.7853896,69.20143984,76.69999695,100,16,65
"768","SLK5_2001_38",2001,2001-07-21,201,2000-10-03,276,147,2001-05-28,236,2001-03-29,98.51440999,37.49741271,12.65999985,87,60,54
"769","SLK1_2001_63",2001,2001-07-20,200,2000-11-14,318,144,2001-05-25,191,2001-04-24,110.5321802,42.89182813,14.73999977,113,31,56
"770","SLK4_2001_64",2001,2001-07-21,201,2000-10-04,277,155,2001-06-05,243,2001-03-29,103.8338041,39.18444538,12.28999996,87,68,46
"771","SLK47_2002_73",2002,2002-07-13,193,2001-10-30,302,100,2002-04-11,163,2002-04-10,121.8830867,46.16191386,44.13285828,99,1,93
"772","SLK6_2001_37",2001,2001-07-20,200,2000-10-09,282,153,2001-06-03,236,2001-03-29,93.31070025,35.34832736,13.83312511,87,66,47
"773","RED1_2002_15",2002,2002-07-17,197,2001-10-24,296,124,2002-05-05,193,2002-04-28,157.0991717,64.02199238,71.41000366,117,7,73
"774","SLK4_2002_17",2002,2002-07-06,186,2001-10-30,302,128,2002-05-09,191,2002-04-28,139.2376188,60.84225367,77.5231049,117,11,58
"775","COC12_2002_53",2002,2002-07-09,189,2001-10-06,278,129,2002-05-10,216,2002-04-28,134.3478704,58.830079,76.48000336,117,12,60
"776","COC19_2002_74",2002,2002-07-12,192,2001-10-09,281,126,2002-05-07,210,2002-04-11,160.8442247,65.16744624,63.54999924,100,26,66
"777","SLK31_2002_89",2002,2002-07-09,189,2001-10-28,300,125,2002-05-06,190,2002-04-28,170.7760683,77.01589389,98.41707836,117,8,64
"778","NIP51_2002_94",2002,2002-07-10,190,2001-10-29,301,118,2002-04-29,182,2002-04-09,110.4355072,44.21576125,41.14963925,98,20,72
"779","RED57_2002_163",2002,2002-07-17,197,2001-11-04,307,112,2002-04-23,170,2002-04-28,154.567701,64.56062854,70.42738499,117,-5,85
"780","SLK30_2002_184",2002,2002-07-09,189,2001-10-30,302,123,2002-05-04,186,2002-04-28,183.8963752,81.62354185,102.0483322,117,6,66
"781","RED37_2002_187",2002,2002-07-14,194,2001-09-13,255,112,2002-04-23,222,2002-04-28,150.7886714,62.8329752,69.7875061,117,-5,82
"782","NIP85_2002_103",2002,2002-07-19,199,2001-11-08,311,101,2002-04-12,155,2002-04-06,89.64060228,21.76537482,11.15999985,95,6,98
"783","NIP75_2002_76",2002,2002-07-16,196,2001-10-21,293,114,2002-04-25,186,2002-04-06,216.5339364,86.99992846,91.81669212,95,19,82
